A|a
B|b
C|c
D|d
E|e
F|f
G|g
H|h
I|i
J|j
K|k
L|l
M|m
N|n
O|o
P|p
Q|q
R|r
S|s
T|t
U|u
V|v
W|w
X|x
Y|j
Z|z
a|a
b|b
c|c
d|d
e|e
f|f
g|g
h|h
i|i
j|j
k|k
l|l
m|m
n|n
o|o
p|p
q|q
r|r
s|s
t|t
u|u
v|v
w|w
x|x
y|j
z|z
É|é
è|è
é|é
ì|ì
ó|ó
ʹ|ʹ
ạ|ạ
Ẹ|ɛ
ẹ|ɛ
Ọ|ɔ
ọ|ɔ
a|a
abaija|abaija
abakuru|abakuru
abawẹ|abawɛ
abe|abe
abel|abel
abigail|abigail
abigẹl|abigɛl
abiram|abiram
abiọmwabiẹ|abiɔʋabiɛ
abo|abo
abotu|abotu
about|about
abraham|abraham
abẹ|abɛ
abọ|abɔ
abọtọ|abɔtɔ
academy|academj
activities|activities
acts|acts
ada|ada
adam|adam
adams|adams
adazẹ|adazɛ
adeghe|adeɣe
adeghẹ|adeɣɛ
adelaide|adelaide
adesẹ|adesɛ
adesẹneva|adesɛneva
adia|adia
adogbannọ|adoɡbannɔ
adolf|adolf
adrrẹsi|adɽɛsi
adrẹsi|adrɛsi
adẹwerriegbe|adɛweɽieɡbe
adọlọ|adɔlɔ
aegean|aegean
afan|afan
afanvbimu|afanʋimu
afiama|afiama
afiangbe|afianɡbe
afianma|afianma
afierhan|afieɾan
afiwerriẹ|afiweɽiɛ
africa|africa
afọ|afɔ
aga|aga
agabagebe|agabagebe
agag|agag
agan|agan
agape|agape
agbada|aɡbada
agbadi|aɡbadi
agbaghuzalẹ|aɡbaɣuzalɛ
agbaziro|aɡbaziro
agbeha|aɡbeha
agbekunsotọ|aɡbekunsotɔ
agbẹkunsotọ|aɡbɛkunsotɔ
agbẹn|aɡbɛn
agbẹnkunsotọ|aɡbɛnkunsotɔ
agbẹnvbo|aɡbɛnʋo
agbọmwa|aɡbɔʋa
agbọn|aɡbɔn
age|age
agele|agele
aghae|aɣae
aghanghan|aɣanɣan
agharhemiẹn|aɣaɾemiɛn
agharhẹmiẹn|aɣaɾɛmiɛn
agikpa|agikpa
agiẹngiẹn|agiɛngiɛn
aguakpa|aguakpa
aguẹ|aguɛ
agọ|agɔ
agọr|agɔr
ahianmwẹ|ahianʋɛ
ahitofẹl|ahitofɛl
ahoo|ahoo
ahoẹmwomwa|ahoɛʋoʋa
ahoẹmwẹ|ahoɛʋɛ
ahoẹmwẹmwa|ahoɛʋɛʋa
ahoẹmwẹọmwa|ahoɛʋɛɔʋa
ahoẹmwọmwa|ahoɛʋɔʋa
ahoọ|ahoɔ
ahọ|ahɔ
ahọemwọmwa|ahɔeʋɔʋa
ai|ai
aighẹru|aiɣɛru
air|air
aiz|aiz
aizaia|aizaia
aizik|aizik
aiziki|aiziki
aka|aka
akharha|axaɾa
akhasẹ|axasɛ
akhaẹn|axaɛn
akhe|axe
akhiẹ|axiɛ
akhuẹ|axuɛ
akiyẹyẹ|akijɛjɛ
ako|ako
akota|akota
akpa|akpa
akpakomiza|akpakomiza
akpan|akpan
akpawẹ|akpawɛ
akpehuan|akpehuan
akpọkọ|akpɔkɔ
aksamai|aksamai
akueyi|akueji
akugbe|akuɡbe
akuila|akuila
akuọkan|akuɔkan
akọn|akɔn
akọwe|akɔwe
ala|ala
alabama|alabama
alagberra|alaɡbeɽa
alagbodẹ|alaɡbodɛ
alaghadaro|alaɣadaro
alaghodaro|alaɣodaro
alama|alama
alamoghẹ|alamoɣɛ
alaotra|alaotra
albania|albania
albert|albert
alejandro|alejandro
alexander|alexander
alimo|alimo
alisa|alisa
allen|allen
alma|alma
almaty|almatj
alubarha|alubaɾa
alughaẹn|aluɣaɛn
alyona|aljona
alzheimer|alzheimer
ama|ama
amagba|amaɡba
amagẹdọn|amagɛdɔn
amaiwẹ|amaiwɛ
amalẹk|amalɛk
amamiẹn|amamiɛn
america|america
ameve|ameve
amigbo|amiɡbo
amnọn|amnɔn
amsterdam|amsterdam
amuegbe|amueɡbe
amuroro|amuroro
amusẹ|amusɛ
amuyọmọ|amujɔmɔ
amuẹntinyan|amuɛntinjan
amuẹtinyan|amuɛtinjan
amwebọ|aʋebɔ
amwẹ|aʋɛ
amẹ|amɛ
amọn|amɔn
an|an
ananaias|ananaias
and|and
angarsk|angarsk
angat|angat
anglican|anglican
animation|animation
ann|ann
anna|anna
answers|answers
antandroy|antandroj
antiọk|antiɔk
anton|anton
app|app
appendix|appendix
apple|apple
application|application
april|april
apsha|apsha
apun|apun
araba|araba
aramaic|aramaic
aranmwẹ|aranʋɛ
aranmwọkhọ|aranʋɔxɔ
arhie|aɾie
arhin|aɾin
arhiọkpaegbe|aɾiɔkpaeɡbe
arhuanran|aɾuanran
arhunmwu|aɾunʋu
arhuẹ|aɾuɛ
arhẹrhẹ|aɾɛɾɛ
arimatia|arimatia
arkansas|arkansas
armagh|armaɣ
armavir|armavir
aro|aro
arovbẹmwẹ|aroʋɛʋɛ
arowa|arowa
arre|aɽe
arria|aɽia
arriaisẹn|aɽiaisɛn
arriavbehe|aɽiaʋehe
arrioba|aɽioba
arriukpa|aɽiukpa
arriọba|aɽiɔba
arriọkpaegbe|aɽiɔkpaeɡbe
arrọọ|aɽɔɔ
arthur|arthur
arudinnodẹ|arudinnodɛ
arọ|arɔ
arọndẹ|arɔndɛ
arọọ|arɔɔ
as|as
asa|asa
asan|asan
asanikaro|asanikaro
ase|ase
asefẹn|asefɛn
ashdod|ashdod
ashtoreth|ashtoreth
asia|asia
asigbe|asiɡbe
asikoko|asikoko
asikẹgbe|asikɛɡbe
asiria|asiria
ask|ask
asobọrrie|asobɔɽie
asoro|asoro
assembly|assemblj
asunción|asunción
asẹ|asɛ
asọn|asɔn
at|at
ata|ata
atamuolọyan|atamuolɔjan
atatabọ|atatabɔ
athens|athens
atkinson|atkinson
atlaẹn|atlaɛn
ato|ato
atosi|atosi
atsuko|atsuko
atuẹ|atuɛ
atuẹwerriegbe|atuɛweɽieɡbe
atẹ|atɛ
atẹns|atɛns
aug|aug
august|august
ausralia|ausralia
austin|austin
australia|australia
austria|austria
avan|avan
avanukhunmwu|avanuxunʋu
avava|avava
avbe|aʋe
avbiẹ|aʋiɛ
avbiẹrẹ|aʋiɛrɛ
awake|awake
awanwan|awanwan
awarọkpa|awarɔkpa
awarọkpani|awarɔkpani
awua|awua
ayabọ|ajabɔ
ayahọmwaehọ|ajahɔʋaehɔ
ayan|ajan
ayawewe|ajawewe
ayayero|ajajero
ayayẹro|ajajɛro
ayayẹrọ|ajajɛrɔ
ayere|ajere
ayi|aji
ayo|ajo
ayobọsekhae|ajobɔsexae
ayọn|ajɔn
aza|aza
azagba|azaɡba
azaia|azaia
azamemwi|azameʋi
azara|azara
azaraia|azaraia
azukpogieva|azukpogieva
azẹ|azɛ
azẹvbiro|azɛʋiro
aʹbo|aʹbo
b|b
ba|ba
baa|baa
baba|baba
babanna|babanna
babilọn|babilɔn
bae|bae
baeku|baeku
baibol|baibol
baibọl|baibɔl
balychy|baljchj
balykchy|baljkchj
balọ|balɔ
ban|ban
banabas|banabas
banban|banban
banbanna|banbanna
bangladesh|bangladesh
bank|bank
bannuan|bannuan
baptist|baptist
bare|bare
barr|baɽ
barọk|barɔk
bath|bath
batsiẹba|batsiɛba
bazely|bazelj
baẹn|baɛn
beat|beat
beck|beck
begbe|beɡbe
beghe|beɣe
beishenbai|beishenbai
belfast|belfast
belgorod|belgorod
believe|believe
ben|ben
benefit|benefit
beni|beni
benjamin|benjamin
berdibaev|berdibaev
bereaved|bereaved
bi|bi
bibi|bibi
bible|bible
bicol|bicol
bie|bie
biegbe|bieɡbe
bii|bii
billion|billion
biro|biro
bishkek|bishkek
bitinia|bitinia
bizugbe|bizuɡbe
bizugbẹe|bizuɡbɛe
biẹ|biɛ
biẹe|biɛe
biẹle|biɛle
biẹlẹ|biɛlɛ
biọ|biɔ
black|black
blossom|blossom
bluff|bluff
bo|bo
boaz|boaz
bob|bob
bodanis|bodanis
bodẹ|bodɛ
bogdan|bogdan
bolo|bolo
book|book
bosnia|bosnia
boston|boston
bound|bound
brandon|brandon
brandt|brandt
brazil|brazil
bridge|bridge
bright|briɣt
brisbane|brisbane
britain|britain
broadcasting|broadcasting
bronx|bronx
brooklyn|brookljn
brothers|brothers
brown|brown
bu|bu
bulacan|bulacan
bulgaria|bulgaria
bully|bullj
bun|bun
bungbe|bunɡbe
buohiẹn|buohiɛn
buru|buru
bẹdi|bɛdi
bẹghe|bɛɣe
bẹkun|bɛkun
bẹnjamin|bɛnjamin
bẹtlẹhẹm|bɛtlɛhɛm
bẹtu|bɛtu
bẹtẹl|bɛtɛl
bọ|bɔ
bọbọ|bɔbɔ
bọdin|bɔdin
bọe|bɔe
bọlọ|bɔlɔ
bọnmwẹ|bɔnʋɛ
c|c
cake|cake
caledonia|caledonia
calvin|calvin
can|can
canada|canada
carl|carl
carlos|carlos
category|categorj
catholic|catholic
cebuano|cebuano
cells|cells
central|central
century|centurj
challenge|challenge
changes|changes
charitable|charitable
charles|charles
charlotte|charlotte
chemosh|chemosh
cheshire|cheshire
chicago|chicago
child|child
chimpoesh|chimpoesh
china|china
chinese|chinese
chocolate|chocolate
chomsky|chomskj
chris|chris
christ|christ
christian|christian
christine|christine
christoph|christoph
church|church
chy|chj
city|citj
claire|claire
cm|cm
coach|coach
coast|coast
coat|coat
cocoa|cocoa
colorado|colorado
columbia|columbia
comfort|comfort
commissioner|commissioner
company|companj
congo|congo
congregation|congregation
connor|connor
construction|construction
control|control
couples|couples
court|court
creator|creator
cruz|cruz
cte|cte
czech|czech
cọr|cɔr
d|d
da|da
daa|daa
dae|dae
daeyi|daeji
dagbẹn|daɡbɛn
daiabitis|daiabitis
daily|dailj
dakaan|dakaan
dakua|dakua
dalene|dalene
damaris|damaris
damaskọs|damaskɔs
damian|damian
dan|dan
danica|danica
daniel|daniel
daniẹl|daniɛl
danlod|danlod
danmwehọ|danʋehɔ
danmwẹ|danʋɛ
danmwẹho|danʋɛho
dannykarl|dannjkarl
darkness|darkness
datan|datan
datie|datie
datu|datu
david|david
dayi|daji
de|de
deba|deba
dec|dec
december|december
dede|dede
dee|dee
defi|defi
defua|defua
degbe|deɡbe
deghe|deɣe
deghẹ|deɣɛ
degue|degue
dekaan|dekaan
dekaẹn|dekaɛn
dekun|dekun
dekẹe|dekɛe
dele|dele
deliverance|deliverance
demu|demu
denmark|denmark
denmarki|denmarki
dennis|dennis
department|department
depression|depression
design|design
devid|devid
dewarorua|dewarorua
dewuarorua|dewuarorua
deyan|dejan
deyọ|dejɔ
deziẹn|deziɛn
di|di
dia|dia
diae|diae
diagbọnya|diaɡbɔnja
diakhẹ|diaxɛ
dianmwiamẹ|dianʋiamɛ
dibu|dibu
dictionary|dictionarj
did|did
didaghohi|didaɣohi
didier|didier
die|die
dies|dies
digiẹ|digiɛ
digiẹn|digiɛn
diguẹ|diguɛ
dihoi|dihoi
din|din
dinariọs|dinariɔs
dinmwi|dinʋi
dinmwiame|dinʋiame
dinmwiamwẹ|dinʋiaʋɛ
dinmwiamẹ|dinʋiamɛ
dinmwianmwẹ|dinʋianʋɛ
dinmwiọn|dinʋiɔn
dinnodẹ|dinnodɛ
district|district
diut|diut
diuteronomi|diuteronomi
divine|divine
dizigha|diziɣa
diẹn|diɛn
do|do
dobọ|dobɔ
dobọyi|dobɔji
does|does
dollar|dollar
don|don
donald|donald
doo|doo
doratine|doratine
dorothy|dorothj
down|down
doẹki|doɛki
dpa|dpa
dublin|dublin
dumaguete|dumaguete
dunmwu|dunʋu
dunna|dunna
dustin|dustin
duẹki|duɛki
dẹ|dɛ
dẹbit|dɛbit
dẹgbẹe|dɛɡbɛe
dẹghe|dɛɣe
dẹlẹ|dɛlɛ
dẹẹ|dɛɛ
dọ|dɔ
dọe|dɔe
dọkas|dɔkas
dọkasi|dɔkasi
dọlegbe|dɔleɡbe
dọlọ|dɔlɔ
dọlọyi|dɔlɔji
dọmwade|dɔʋade
dọmwadẹ|dɔʋadɛ
dọmwadọghẹ|dɔʋadɔɣɛ
dọmwadọghẹe|dɔʋadɔɣɛe
dọmwadọghọe|dɔʋadɔɣɔe
dọmwandẹ|dɔʋandɛ
dọn|dɔn
dọyọ|dɔjɔ
e|e
earl|earl
easily|easilj
east|east
ebamiro|ebamiro
eban|eban
ebanban|ebanban
ebe|ebe
ebi|ebi
ebiebi|ebiebi
ebiro|ebiro
ebo|ebo
ebraham|ebraham
ebu|ebu
ebubẹ|ebubɛ
ebuka|ebuka
ebunbunmwẹhẹn|ebunbunʋɛhɛn
ebẹdi|ebɛdi
ebẹl|ebɛl
ebọ|ebɔ
ecclesiasticus|ecclesiasticus
ecija|ecija
edagbọn|edaɡbɔn
edanmwẹ|edanʋɛ
edigue|edigue
ediran|ediran
ediọn|ediɔn
ediọnmwa|ediɔnʋa
edo|edo
edogbandogban|edoɡbandoɡban
edogbo|edoɡbo
eduard|eduard
eduardo|eduardo
education|education
edunna|edunna
edward|edward
edọmwade|edɔʋade
edọmwadẹ|edɔʋadɛ
edọmwande|edɔʋande
efaa|efaa
efe|efe
efis|efis
efisọs|efisɔs
efoni|efoni
efoto|efoto
egba|eɡba
egbakhian|eɡbaxian
egbe|eɡbe
egberran|eɡbeɽan
egberranmwẹ|eɡbeɽanʋɛ
egberriotọ|eɡbeɽiotɔ
egberọkhọmwẹ|eɡberɔxɔʋɛ
egbewọmwẹ|eɡbewɔʋɛ
egbowa|eɡbowa
egbua|eɡbua
egbuẹ|eɡbuɛ
egbẹ|eɡbɛ
egbẹe|eɡbɛe
egbọre|eɡbɔre
egebe|egebe
egedege|egedege
eghan|eɣan
eghaẹvbo|eɣaɛʋo
eghe|eɣe
eghian|eɣian
eghute|eɣute
eghẹ|eɣɛ
eghẹnghẹn|eɣɛnɣɛn
eghọẹn|eɣɔɛn
egiaye|egiaje
egie|egie
egiọn|egiɔn
eguọmwadia|eguɔʋadia
eha|eha
ehan|ehan
ehaz|ehaz
ehe|ehe
ehia|ehia
ehuanegbe|ehuaneɡbe
ehẹn|ehɛn
ehọ|ehɔ
ehọnrre|ehɔnɽe
ei|ei
ejvor|ejvor
eka|eka
ekad|ekad
ekan|ekan
ekaolotu|ekaolotu
ekaptaki|ekaptaki
eke|eke
ekesugie|ekesugie
ekhae|exae
ekhakha|exaxa
ekhaẹmwẹ|exaɛʋɛ
ekhoẹ|exoɛ
ekhuarho|exuaɾo
ekhue|exue
ekhẹn|exɛn
ekhọe|exɔe
ekhọesi|exɔesi
eki|eki
ekita|ekita
eko|eko
ekoboko|ekoboko
ekokoudu|ekokoudu
ekorhiẹnrhiẹnmwẹ|ekoɾiɛnɾiɛnʋɛ
ekpa|ekpa
ekpakpasusu|ekpakpasusu
ekpataki|ekpataki
ekpayẹ|ekpajɛ
ekpẹn|ekpɛn
ekpọ|ekpɔ
ekpọnmwẹ|ekpɔnʋɛ
eku|eku
ekueku|ekueku
ekẹn|ekɛn
ekẹtẹkẹtẹ|ekɛtɛkɛtɛ
ekọ|ekɔ
ekọmputa|ekɔmputa
elaihu|elaihu
elena|elena
eliaikim|eliaikim
elias|elias
elikhukhu|elixuxu
elizabeth|elizabeth
elizabẹt|elizabɛt
elkana|elkana
elẹta|elɛta
ema|ema
emadogua|emadogua
emamwaemwi|emaʋaeʋi
emana|emana
emasini|emasini
ematọn|ematɔn
emaọs|emaɔs
emi|emi
emianmwẹ|emianʋɛ
emil|emil
emiowo|emiowo
emo|emo
emobọ|emobɔ
emotọ|emotɔ
emu|emu
emuẹn|emuɛn
emwa|eʋa
emwamwa|eʋaʋa
emwata|eʋata
emwi|eʋi
emwidamwẹ|eʋidaʋɛ
emwidan|eʋidan
emwikemwi|eʋikeʋi
emwiokọ|eʋiokɔ
emwiorhọ|eʋioɾɔ
emọ|emɔ
emọle|emɔle
emọs|emɔs
ena|ena
enakpolugho|enakpoluɣo
enaye|enaje
encyclopedia|encjclopedia
enduring|enduring
ene|ene
enegbe|eneɡbe
enene|enene
enenẹ|enenɛ
england|england
eni|eni
enibun|enibun
enikẹre|enikɛre
enina|enina
eniwanrẹn|eniwanrɛn
eniwu|eniwu
enjoyable|enjojable
enogieva|enogieva
enẹ|enɛ
enẹirrọvbugie|enɛiɽɔʋugie
enọ|enɔ
enọk|enɔk
enọkpa|enɔkpa
enọmba|enɔmba
enọwanrẹn|enɔwanrɛn
enọwarẹn|enɔwarɛn
enọyan|enɔjan
enọyaẹnmwa|enɔjaɛnʋa
epilepsy|epilepsj
ere|ere
erha|eɾa
erhae|eɾae
erhan|eɾan
erhavbavbotọ|eɾaʋaʋotɔ
erhu|eɾu
erhuanegbe|eɾuaneɡbe
erhunmwu|eɾunʋu
erhunmwuyẹn|eɾunʋujɛn
erhẹn|eɾɛn
erhọkpa|eɾɔkpa
ericka|ericka
erika|erika
erinmwi|erinʋi
erinmwian|erinʋian
ero|ero
erre|eɽe
erria|eɽia
erriọ|eɽiɔ
erriọvbe|eɽiɔʋe
erẹnrẹn|erɛnrɛn
erẹrẹ|erɛrɛ
erọn|erɔn
esa|esa
esagiẹn|esagiɛn
esakan|esakan
esankan|esankan
ese|ese
eseghan|eseɣan
esi|esi
esia|esia
esiesi|esiesi
esiga|esiga
esiliva|esiliva
esiọre|esiɔre
eso|eso
estonia|estonia
esu|esu
esọsi|esɔsi
etalọ|etalɔ
etan|etan
etebul|etebul
eteburu|eteburu
eternal|eternal
eti|eti
etian|etian
etien|etien
etisa|etisa
etiẹn|etiɛn
etiọn|etiɔn
etiọnrẹn|etiɔnrɛn
eto|eto
eturari|eturari
etuẹn|etuɛn
etẹbitẹ|etɛbitɛ
etẹlifoni|etɛlifoni
etẹn|etɛn
euodia|euodia
europe|europe
eva|eva
evangelizers|evangelizers
evba|eʋa
evbagbẹn|eʋaɡbɛn
evbakọnrẹn|eʋakɔnrɛn
evbare|eʋare
evbavba|eʋaʋa
evbayi|eʋaji
evbibie|eʋibie
evbibiemọ|eʋibiemɔ
evbibiran|eʋibiran
evbibiẹ|eʋibiɛ
evbibiẹmwẹ|eʋibiɛʋɛ
evbibiẹmọ|eʋibiɛmɔ
evbibiọ|eʋibiɔ
evbo|eʋo
evburriẹ|eʋuɽiɛ
evbọ|eʋɔ
evbọzẹe|eʋɔzɛe
eve|eve
eveva|eveva
eviẹn|eviɛn
evẹn|evɛn
ewanmwẹ|ewanʋɛ
ewanniẹn|ewanniɛn
ewaẹn|ewaɛn
ewe|ewe
ewindo|ewindo
ewẹn|ewɛn
ewọwọ|ewɔwɔ
exercise|exercise
experiences|experiences
eyan|ejan
eyist|ejist
eyẹ|ejɛ
ezanzan|ezanzan
ezik|ezik
ezikiẹl|ezikiɛl
ezra|ezra
ezọbu|ezɔbu
f|f
fa|fa
facebook|facebook
fafaa|fafaa
fai|fai
fajardo|fajardo
family|familj
fan|fan
fannọ|fannɔ
farisi|farisi
faẹn|faɛn
fe|fe
february|februarj
federico|federico
feldbach|feldbach
felix|felix
fero|fero
fi|fi
fiabọ|fiabɔ
fian|fian
fiangbe|fianɡbe
fiangbua|fianɡbua
fiangbuẹ|fianɡbuɛ
fiangbẹe|fianɡbɛe
fiaẹn|fiaɛn
fibi|fibi
fidọn|fidɔn
fiegbua|fieɡbua
fieghe|fieɣe
fifi|fifi
fil|fil
filip|filip
filipai|filipai
filippai|filippai
filo|filo
finch|finch
fiohan|fiohan
fioro|fioro
fira|fira
firaa|firaa
fists|fists
fiwerriẹ|fiweɽiɛ
fiyekegbe|fijekeɡbe
fiyekegbẹe|fijekeɡbɛe
fiẹ|fiɛ
flavius|flavius
florida|florida
fo|fo
foni|foni
foo|foo
for|for
forrest|foɽest
fot|fot
foto|foto
foẹ|foɛ
france|france
franz|franz
fred|fred
frederick|frederick
free|free
freetown|freetown
french|french
from|from
ftn|ftn
fu|fu
fua|fua
fuan|fuan
fulham|fulham
furre|fuɽe
fuẹ|fuɛ
fuẹn|fuɛn
fuẹro|fuɛro
fuẹrọ|fuɛrɔ
fìangbe|fìanɡbe
fẹfẹfẹ|fɛfɛfɛ
fẹko|fɛko
fẹẹre|fɛɛre
fẹẹrẹ|fɛɛrɛ
fọ|fɔ
fọfua|fɔfua
fọnbọ|fɔnbɔ
ga|ga
gaa|gaa
gablọ|gablɔ
gabriẹl|gabriɛl
gaby|gabj
gada|gada
gae|gae
gaelic|gaelic
gaga|gaga
gal|gal
galatia|galatia
galaxy|galaxj
galili|galili
gamaliel|gamaliel
game|game
games|games
gary|garj
gaʹpe|gaʹpe
gba|ɡba
gbaa|ɡbaa
gbaan|ɡbaan
gbae|ɡbae
gbaengbe|ɡbaenɡbe
gbagba|ɡbaɡba
gbagbae|ɡbaɡbae
gbain|ɡbain
gbakhia|ɡbaxia
gbakiyẹyẹ|ɡbakijɛjɛ
gbalaka|ɡbalaka
gbalọ|ɡbalɔ
gbalọe|ɡbalɔe
gbamẹ|ɡbamɛ
gban|ɡban
gbanegbe|ɡbaneɡbe
gbannọ|ɡbannɔ
gbannọẹn|ɡbannɔɛn
gbaro|ɡbaro
gbaroghe|ɡbaroɣe
gbaroghẹ|ɡbaroɣɛ
gbarokotọ|ɡbarokotɔ
gbawawẹ|ɡbawawɛ
gbaẹnegbe|ɡbaɛneɡbe
gbaẹngbe|ɡbaɛnɡbe
gbe|ɡbe
gbegba|ɡbeɡba
gbehọ|ɡbehɔ
gbekhakha|ɡbexaxa
gbele|ɡbele
gbennẹ|ɡbennɛ
gberra|ɡbeɽa
gberrra|ɡbeɽra
gbii|ɡbii
gbikhaẹn|ɡbixaɛn
gbinna|ɡbinna
gbiri|ɡbiri
gbiruẹn|ɡbiruɛn
gbodan|ɡbodan
gbodin|ɡbodin
gbodoo|ɡbodoo
gbogba|ɡboɡba
gbogiẹ|ɡbogiɛ
gbokhuo|ɡboxuo
gbokhuẹre|ɡboxuɛre
gbolighi|ɡboliɣi
gbotọ|ɡbotɔ
gbua|ɡbua
gbuẹ|ɡbuɛ
gbẹ|ɡbɛ
gbẹbu|ɡbɛbu
gbẹdọ|ɡbɛdɔ
gbẹe|ɡbɛe
gbẹkunsotọ|ɡbɛkunsotɔ
gbẹn|ɡbɛn
gbẹnnẹ|ɡbɛnnɛ
gbẹro|ɡbɛro
gbẹrorua|ɡbɛrorua
gbọ|ɡbɔ
gbọba|ɡbɔba
gbọbokhian|ɡbɔboxian
gbọvo|ɡbɔvo
gbọyemwẹ|ɡbɔjeʋɛ
gbọyẹmmwẹ|ɡbɔjɛmʋɛ
gbọyẹmwe|ɡbɔjɛʋe
gbọyẹmwẹ|ɡbɔjɛʋɛ
gbọzinia|ɡbɔzinia
gbọzinian|ɡbɔzinian
gbọọ|ɡbɔɔ
gebrẹl|gebrɛl
gehazi|gehazi
gele|gele
gelegele|gelegele
george|george
germany|germanj
gha|ɣa
ghaa|ɣaa
ghaan|ɣaan
ghae|ɣae
ghagha|ɣaɣa
ghan|ɣan
ghe|ɣe
ghee|ɣee
gheghe|ɣeɣe
ghete|ɣete
ghi|ɣi
gho|ɣo
ghogho|ɣoɣo
ghughẹ|ɣuɣɛ
ghẹ|ɣɛ
ghẹghẹ|ɣɛɣɛ
ghẹghẹghẹ|ɣɛɣɛɣɛ
ghẹẹ|ɣɛɛ
ghọghọ|ɣɔɣɔ
gi|gi
gia|gia
giagia|giagia
giamafon|giamafon
gidi|gidi
gie|gie
gilead|gilead
giliad|giliad
gill|gill
gima|gima
ginna|ginna
ginnaẹn|ginnaɛn
gio|gio
giuan|giuan
giẹ|giɛ
giẹgiẹ|giɛgiɛ
giẹn|giɛn
giẹre|giɛre
giẹrẹ|giɛrɛ
giọg|giɔg
gloria|gloria
glorify|glorifj
gloves|gloves
go|go
goals|goals
god|god
gog|gog
golaiat|golaiat
golaiati|golaiati
golden|golden
gomorra|gomoɽa
goo|goo
good|good
gorkiy|gorkij
gothic|gothic
government|government
graham|graham
grant|grant
graz|graz
great|great
greece|greece
greek|greek
grigory|grigorj
grik|grik
griki|griki
grounds|grounds
grójec|grójec
gu|gu
gua|gua
guadeloupe|guadeloupe
guae|guae
guaekpa|guaekpa
guaero|guaero
guakpa|guakpa
gualọ|gualɔ
gualọe|gualɔe
guan|guan
guanrẹn|guanrɛn
guard|guard
guaẹro|guaɛro
gue|gue
gui|gui
guide|guide
guides|guides
gujarat|gujarat
gujarati|gujarati
gulsayra|gulsajra
gurọọ|gurɔɔ
guẹ|guɛ
guẹhun|guɛhun
guẹzẹ|guɛzɛ
guọ|guɔ
guọghua|guɔɣua
guọghọ|guɔɣɔ
guọghọe|guɔɣɔe
guọrọ|guɔrɔ
gẹdẹgbẹ|gɛdɛɡbɛ
gẹdẹgbẹe|gɛdɛɡbɛe
gẹdẹgbẹẹ|gɛdɛɡbɛɛ
gẹn|gɛn
gẹnẹsis|gɛnɛsis
gọ|gɔ
gọvina|gɔvina
h|h
ha|ha
haan|haan
hab|hab
habakọk|habakɔk
hae|hae
hag|hag
haiyan|haijan
halloween|halloween
han|han
hana|hana
hananaia|hananaia
hanmwa|hanʋa
hanmwan|hanʋan
hanna|hanna
hanne|hanne
hannọ|hannɔ
hannọẹn|hannɔɛn
hans|hans
happiness|happiness
hardaker|hardaker
harold|harold
harry|haɽj
hausa|hausa
hawa|hawa
he|he
health|health
heart|heart
hearts|hearts
heather|heather
hebrew|hebrew
hee|hee
hega|hega
heights|heiɣts
heldai|heldai
heli|heli
hell|hell
hemsworth|hemsworth
henri|henri
henry|henrj
henschel|henschel
henshall|henshall
herd|herd
hezikaia|hezikaia
hia|hia
hianrẹn|hianrɛn
hib|hib
hibru|hibru
hie|hie
hiehie|hiehie
high|hiɣ
hihiẹ|hihiɛ
hin|hin
hindu|hindu
hinrin|hinrin
hinusi|hinusi
hio|hio
hiokhuan|hioxuan
history|historj
hitler|hitler
hiunsi|hiunsi
hiẹ|hiɛ
hiẹn|hiɛn
hiẹre|hiɛre
hiẹrẹ|hiɛrɛ
hiọnrọn|hiɔnrɔn
hlybokyy|hljbokjj
ho|ho
hogha|hoɣa
hoghaa|hoɣaa
holding|holding
hollywood|holljwood
holy|holj
honduras|honduras
honor|honor
hoo|hoo
hormone|hormone
horẹb|horɛb
hoshayahu|hoshajahu
hotẹl|hotɛl
how|how
hoz|hoz
hozia|hozia
hoẹmwe|hoɛʋe
hoẹmwẹ|hoɛʋɛ
hu|hu
huan|huan
huanrẹn|huanrɛn
huaro|huaro
hughes|huɣes
hungary|hungarj
huntsinger|huntsinger
hunwan|hunwan
hurricane|huɽicane
hutter|hutter
huẹn|huɛn
huọn|huɔn
hypertension|hjpertension
hẹ|hɛ
hẹe|hɛe
hẹko|hɛko
hẹn|hɛn
hẹnhẹn|hɛnhɛn
hẹnnẹ|hɛnnɛ
hẹnnẹdẹn|hɛnnɛdɛn
hẹnnẹhẹnnẹ|hɛnnɛhɛnnɛ
hẹrọd|hɛrɔd
hẹwẹ|hɛwɛ
hẹzekaia|hɛzekaia
hẹzikaia|hɛzikaia
họ|hɔ
họemwẹ|hɔeʋɛ
họen|hɔen
họn|hɔn
họẹn|hɔɛn
i|i
ibare|ibare
ibata|ibata
ibavbaro|ibaʋaro
ibeleku|ibeleku
ibiba|ibiba
ibiriki|ibiriki
ibisi|ibisi
ibiẹ|ibiɛ
ibiẹka|ibiɛka
ibo|ibo
ibowa|ibowa
ibozẹghẹ|ibozɛɣɛ
ibriki|ibriki
ibuanro|ibuanro
ibude|ibude
ibudẹ|ibudɛ
ibuohiẹn|ibuohiɛn
ibọkpọ|ibɔkpɔ
ibọlu|ibɔlu
ibọru|ibɔru
ida|ida
idaehọ|idaehɔ
idagbo|idaɡbo
idan|idan
ideghedeghe|ideɣedeɣe
idiaghe|idiaɣe
idin|idin
idinmwiamwẹ|idinʋiaʋɛ
idinmwiamẹ|idinʋiamɛ
idobo|idobo
idobọ|idobɔ
idu|idu
idugie|idugie
idunmwu|idunʋu
idẹn|idɛn
idẹni|idɛni
ifi|ifi
ifiẹmwẹ|ifiɛʋɛ
ifiẹzo|ifiɛzo
ifiẹzọ|ifiɛzɔ
iflawa|iflawa
ifuanro|ifuanro
ifuẹko|ifuɛko
ifuẹn|ifuɛn
ifuẹro|ifuɛro
ifẹnmwẹ|ifɛnʋɛ
igan|igan
igarawa|igarawa
igba|iɡba
igbaha|iɡbaha
igbama|iɡbama
igban|iɡban
igbaroghe|iɡbaroɣe
igbava|iɡbava
igbe|iɡbe
igbedia|iɡbedia
igbinna|iɡbinna
igbinnguo|iɡbinnguo
igbinnoguo|iɡbinnoguo
igbiragia|iɡbiragia
igbodan|iɡbodan
igbohiotọ|iɡbohiotɔ
igbohiọtọ|iɡbohiɔtɔ
igbukpọn|iɡbukpɔn
igbọn|iɡbɔn
igbọvo|iɡbɔvo
ighaegbe|iɣaeɡbe
ighe|iɣe
igho|iɣo
ighobioye|iɣobioje
ighogho|iɣoɣo
ighẹ|iɣɛ
ighọ|iɣɔ
ighọnmwighọn|iɣɔnʋiɣɔn
igie|igie
igiemwi|igieʋi
igiode|igiode
igiodu|igiodu
igiodẹ|igiodɛ
igiogbe|igioɡbe
igiogbẹ|igioɡbɛ
igiowa|igiowa
igipt|igipt
igiuhunmwu|igiuhunʋu
igiẹ|igiɛ
igiẹmwi|igiɛʋi
igiọdu|igiɔdu
igoru|igoru
igue|igue
iguẹ|iguɛ
igẹbọ|igɛbɔ
igẹdu|igɛdu
ihako|ihako
ihan|ihan
ihe|ihe
ihegbe|iheɡbe
iheva|iheva
ihiehie|ihiehie
ihin|ihin
ihinrin|ihinrin
ihinrọn|ihinrɔn
iho|iho
ihoi|ihoi
ihua|ihua
ihuan|ihuan
ihue|ihue
ihunhun|ihunhun
ihẹ|ihɛ
ihẹghẹ|ihɛɣɛ
ihẹn|ihɛn
ihẹwẹ|ihɛwɛ
ii|ii
ika|ika
ikadẹlẹ|ikadɛlɛ
ike|ike
ikeferi|ikeferi
ikerhan|ikeɾan
ikhi|ixi
ikhuiwu|ixuiwu
ikhuo|ixuo
ikhọ|ixɔ
ikian|ikian
ikinkin|ikinkin
ikinnegbe|ikinneɡbe
iko|iko
ikobọ|ikobɔ
ikolo|ikolo
ikoroba|ikoroba
ikpadede|ikpadede
ikpakpa|ikpakpa
ikpamẹ|ikpamɛ
ikpanro|ikpanro
ikpe|ikpe
ikpemehe|ikpemehe
ikpia|ikpia
ikpianbọ|ikpianbɔ
ikpokuta|ikpokuta
ikporhu|ikpoɾu
ikpẹ|ikpɛ
ikpẹdẹ|ikpɛdɛ
ikpẹmwẹ|ikpɛʋɛ
ikpọka|ikpɔka
iku|iku
ikuaengbe|ikuaenɡbe
ikuanegbe|ikuaneɡbe
ikuanzọ|ikuanzɔ
ikueta|ikueta
ikun|ikun
ikẹkẹ|ikɛkɛ
ikọ|ikɔ
ilavbodẹ|ilaʋodɛ
ile|ile
ilekhue|ilexue
ilele|ilele
ilẹkẹtin|ilɛkɛtin
ima|ima
imamwaemwi|imaʋaeʋi
ime|ime
imina|imina
imiẹfan|imiɛfan
imiẹnfan|imiɛnfan
imotọ|imotɔ
imu|imu
imuanẹmwẹ|imuanɛʋɛ
imuaẹmwẹ|imuaɛʋɛ
imudia|imudia
imudiase|imudiase
imudiaẹse|imudiaɛse
imuegberriotọ|imueɡbeɽiotɔ
imuohan|imuohan
imẹ|imɛ
imọto|imɔto
in|in
inches|inches
increase|increase
index|index
india|india
indiana|indiana
indus|indus
inian|inian
insight|insiɣt
insurance|insurance
intanẹt|intanɛt
interviews|interviews
inu|inu
inugba|inuɡba
inọk|inɔk
inọta|inɔta
ionash|ionash
ipalọ|ipalɔ
ipapa|ipapa
iran|iran
irangbe|iranɡbe
ireland|ireland
irene|irene
irhioya|iɾioja
irhiẹdẹ|iɾiɛdɛ
irhiọha|iɾiɔha
irhuarhua|iɾuaɾua
irin|irin
irina|irina
irish|irish
irkutsk|irkutsk
iro|iro
irorinmwi|irorinʋi
irri|iɽi
irrioya|iɽioja
irunmwu|irunʋu
iruẹmwi|iruɛʋi
iruẹn|iruɛn
irẹn|irɛn
irẹnmwi|irɛnʋi
irẹnmwẹ|irɛnʋɛ
irọkhegbe|irɔxeɡbe
is|is
isa|isa
isanhẹn|isanhɛn
isanrẹn|isanrɛn
isaranmwẹ|isaranʋɛ
isasa|isasa
isasegbe|isaseɡbe
isi|isi
isievẹn|isievɛn
isimwinegbe|isiʋineɡbe
isinmwegbe|isinʋeɡbe
isinmwiegbe|isinʋieɡbe
isinmwinegbe|isinʋineɡbe
isiwinna|isiwinna
isiwnna|isiwnna
island|island
ismẹl|ismɛl
iso|iso
isonorhọ|isonoɾɔ
istanbul|istanbul
isu|isu
isẹ|isɛ
isẹn|isɛn
isọ|isɔ
isọtẹ|isɔtɛ
italy|italj
itan|itan
itanẹt|itanɛt
itanẹti|itanɛti
itegbe|iteɡbe
itengbemu|itenɡbemu
itie|itie
ititi|ititi
itohan|itohan
itota|itota
itowa|itowa
itẹ|itɛ
iud|iud
ivbabọ|iʋabɔ
ivbi|iʋi
ivbialeke|iʋialeke
ivbibiemọ|iʋibiemɔ
ivbibiẹ|iʋibiɛ
ivbie|iʋie
ivbiogue|iʋiogue
ivbiotu|iʋiotu
ivbioyokuo|iʋiojokuo
ivbiran|iʋiran
ivbiyokhuo|iʋijoxuo
ivbiyokuo|iʋijokuo
ivbiẹ|iʋiɛ
ivbiẹre|iʋiɛre
ivbiọtu|iʋiɔtu
ivbuẹ|iʋuɛ
ive|ive
ivi|ivi
ivin|ivin
ivoire|ivoire
ivory|ivorj
iwannegbe|iwanneɡbe
iwe|iwe
iwegbe|iweɡbe
iweha|iweha
iweva|iweva
iwiina|iwiina
iwinna|iwinna
iwo|iwo
iwu|iwu
iyan|ijan
iyayi|ijaji
iye|ije
iyehan|ijehan
iyeke|ijeke
iyemwẹ|ijeʋɛ
iyeva|ijeva
iyi|iji
iyin|ijin
iyisẹn|ijisɛn
iyobemwahia|ijobeʋahia
iyobemwihia|ijobeʋihia
iyobo|ijobo
iyobọ|ijobɔ
iyokuo|ijokuo
iyowa|ijowa
iyuẹ|ijuɛ
iyẹ|ijɛ
iyẹe|ijɛe
iyẹn|ijɛn
iyọbọ|ijɔbɔ
izabọ|izabɔ
izedu|izedu
izigan|izigan
izigha|iziɣa
izinegbe|izineɡbe
iziro|iziro
izirọ|izirɔ
izmir|izmir
izrel|izrel
izrẹl|izrɛl
izẹl|izɛl
izọese|izɔese
izọghae|izɔɣae
izọhẹ|izɔhɛ
izọla|izɔla
j|j
jack|jack
jacob|jacob
jairọs|jairɔs
jakẹ|jakɛ
james|james
jane|jane
janet|janet
january|januarj
japan|japan
jared|jared
jason|jason
jean|jean
jedaia|jedaia
jehava|jehava
jehova|jehova
jehovah|jehovah
jehove|jehove
jehovo|jehovo
jekọb|jekɔb
jems|jems
jennifer|jennifer
jensen|jensen
jer|jer
jerimaia|jerimaia
jerusalam|jerusalam
jerusalem|jerusalem
jerusalẹm|jerusalɛm
jese|jese
jessica|jessica
jessie|jessie
jesu|jesu
jesus|jesus
jew|jew
joas|joas
job|job
johannes|johannes
johannesburg|johannesburg
john|john
johnny|johnnj
jona|jona
jonatan|jonatan
jordan|jordan
jos|jos
joseph|joseph
josephus|josephus
josua|josua
josẹf|josɛf
josẹfi|josɛfi
joyfully|jojfullj
joẹl|joɛl
jr|jr
ju|ju
jud|jud
juda|juda
judah|judah
judaism|judaism
judas|judas
judia|judia
judith|judith
judy|judj
julia|julia
july|julj
jumpei|jumpei
june|june
junia|junia
jusu|jusu
jw|jw
jẹfta|jɛfta
jẹriko|jɛriko
jọdan|jɔdan
jọn|jɔn
jọs|jɔs
jọsua|jɔsua
ka|ka
kaan|kaan
kad|kad
kadi|kadi
kae|kae
kaiafas|kaiafas
kaka|kaka
kakabọ|kakabɔ
kamẹl|kamɛl
kamẹra|kamɛra
kan|kan
kanmwa|kanʋa
kano|kano
kansa|kansa
kant|kant
kapadosia|kapadosia
karachi|karachi
karavan|karavan
karo|karo
katekate|katekate
katharina|katharina
katilac|katilac
katọn|katɔn
kayla|kajla
kazakhstan|kazaxstan
kazuhiro|kazuhiro
kaẹn|kaɛn
ke|ke
kedẹs|kedɛs
keep|keep
kegha|keɣa
keghi|keɣi
kei|kei
keni|keni
kere|kere
keritot|keritot
kevba|keʋa
kevbe|keʋe
kevin|kevin
kg|kg
kha|xa
khabe|xabe
khaemwisẹ|xaeʋisɛ
khaevbisẹ|xaeʋisɛ
khakha|xaxa
khama|xama
khan|xan
khare|xare
kharha|xaɾa
khekherriọ|xexeɽiɔ
kherhe|xeɾe
khia|xia
khian|xian
khianrẹn|xianrɛn
khin|xin
khirhi|xiɾi
khiẹ|xiɛ
khiẹkhiẹ|xiɛxiɛ
khiẹn|xiɛn
khiẹnnẹ|xiɛnnɛ
khiọ|xiɔ
khu|xu
khua|xua
khuan|xuan
khuankhuan|xuanxuan
khuankhuankhuan|xuanxuanxuan
khue|xue
khui|xui
khuikhui|xuixui
khuiwu|xuiwu
khulo|xulo
khuo|xuo
khuẹ|xuɛ
khuẹn|xuɛn
khuẹnniẹn|xuɛnniɛn
khuẹrhẹ|xuɛɾɛ
khuọnmwi|xuɔnʋi
khẹ|xɛ
khẹdọkpa|xɛdɔkpa
khẹke|xɛke
khẹkhẹ|xɛxɛ
khọ|xɔ
khọn|xɔn
khọnmiotọ|xɔnmiotɔ
khọnrẹn|xɔnrɛn
khọrhiọuan|xɔɾiɔuan
khọọn|xɔɔn
ki|ki
kiana|kiana
kie|kie
kiekie|kiekie
kiere|kiere
kii|kii
kim|kim
kin|kin
king|king
kingdom|kingdom
kinmwi|kinʋi
kinmwin|kinʋin
kinnegbe|kinneɡbe
kiri|kiri
kkk|kkk
klan|klan
klas|klas
klasi|klasi
klass|klass
klaus|klaus
klik|klik
klux|klux
klọb|klɔb
knorr|knoɽ
knọrr|knɔɽ
koko|koko
kolkhoz|kolxoz
kor|kor
kora|kora
korea|korea
kotọ|kotɔ
koyọ|kojɔ
koẹ|koɛ
kpa|kpa
kpaa|kpaa
kpaegbe|kpaeɡbe
kpannọ|kpannɔ
kpaodin|kpaodin
kpasi|kpasi
kpasẹ|kpasɛ
kpataki|kpataki
kpe|kpe
kpee|kpee
kpemehe|kpemehe
kpere|kpere
kpigho|kpiɣo
kpikpi|kpikpi
kpokpo|kpokpo
kpolo|kpolo
kpopkpo|kpopkpo
kporhu|kpoɾu
kpẹ|kpɛ
kpẹe|kpɛe
kpẹre|kpɛre
kpẹẹ|kpɛɛ
kpọ|kpɔ
kpọlọ|kpɔlɔ
kpọnmwẹ|kpɔnʋɛ
kpọnmwọn|kpɔnʋɔn
kraker|kraker
kristi|kristi
krrẹdit|kɽɛdit
krọ|krɔ
krọnikol|krɔnikol
ku|ku
kua|kua
kuan|kuan
kue|kue
kugbe|kuɡbe
kun|kun
kurganinsk|kurganinsk
kuẹ|kuɛ
kuẹi|kuɛi
kuẹn|kuɛn
kuọ|kuɔ
kvbe|kʋe
kyoko|kjoko
kyrgyz|kjrgjz
kyrgyzstan|kjrgjzstan
kẹ|kɛ
kẹghi|kɛɣi
kẹkan|kɛkan
kẹkua|kɛkua
kẹkẹ|kɛkɛ
kẹre|kɛre
kẹrikian|kɛrikian
kẹvbe|kɛʋe
kẹvbẹ|kɛʋɛ
kọ|kɔ
kọe|kɔe
kọl|kɔl
kọlose|kɔlose
kọlosse|kɔlosse
kọlọe|kɔlɔe
kọmpas|kɔmpas
kọmpasi|kɔmpasi
kọmpini|kɔmpini
kọmputa|kɔmputa
kọn|kɔn
kọniliọs|kɔniliɔs
kọnkọn|kɔnkɔn
kọnrinti|kɔnrinti
kọr|kɔr
kọrinti|kɔrinti
l|l
la|la
laban|laban
ladian|ladian
lae|lae
lagberra|laɡbeɽa
lagos|lagos
lahin|lahin
lahore|lahore
lahọ|lahɔ
lalọ|lalɔ
lamẹk|lamɛk
lamẹki|lamɛki
land|land
language|language
lanka|lanka
lansing|lansing
lao|lao
laodisia|laodisia
larre|laɽe
latin|latin
latvia|latvia
law|law
lazarọs|lazarɔs
lazarọsi|lazarɔsi
laọ|laɔ
le|le
leads|leads
learn|learn
led|led
lefèvre|lefèvre
leigh|leiɣ
lekpa|lekpa
lekpae|lekpae
lele|lele
lelẹe|lelɛe
lene|lene
leon|leon
leone|leone
lett|lett
leukemia|leukemia
lev|lev
levbasevba|leʋaseʋa
li|li
lia|lia
liberty|libertj
library|librarj
lidia|lidia
life|life
lighi|liɣi
light|liɣt
lights|liɣts
lighua|liɣua
link|link
listra|listra
livai|livai
liver|liver
liverpool|liverpool
lives|lives
livija|livija
liz|liz
lo|lo
local|local
logho|loɣo
lollards|lollards
london|london
long|long
loo|loo
looro|looro
los|los
lost|lost
lottie|lottie
louis|louis
lovbiẹ|loʋiɛ
love|love
lran|lran
luca|luca
lucia|lucia
lughaẹn|luɣaɛn
lughuaẹn|luɣuaɛn
lughọlughọ|luɣɔluɣɔ
luigi|luigi
luk|luk
luke|luke
lusitania|lusitania
luther|luther
luxembourg|luxembourg
luzon|luzon
luẹluẹe|luɛluɛe
lẹ|lɛ
lẹfua|lɛfua
lẹga|lɛga
lẹgae|lɛgae
lẹgbinna|lɛɡbinna
lẹgbinnaẹn|lɛɡbinnaɛn
lẹre|lɛre
lẹruegbe|lɛrueɡbe
lẹv|lɛv
lẹvitikus|lɛvitikus
lọghọ|lɔɣɔ
lọghọe|lɔɣɔe
lọkọ|lɔkɔ
lọt|lɔt
lọọ|lɔɔ
m|m
ma|ma
maa|maa
maan|maan
madagascar|madagascar
madeleine|madeleine
madison|madison
madre|madre
magog|magog
mai|mai
maika|maika
mail|mail
mainọ|mainɔ
mairambubu|mairambubu
mak|mak
make|make
makenzie|makenzie
mal|mal
malagasy|malagasj
malakai|malakai
malayalam|malajalam
mama|mama
mambetsadykova|mambetsadjkova
mandalay|mandalaj
mangoro|mangoro
manọẹn|manɔɛn
map|map
march|march
mari|mari
maria|maria
marie|marie
marina|marina
marthe|marthe
martin|martin
mary|marj
masa|masa
masidonia|masidonia
masih|masih
masini|masini
massachusetts|massachusetts
mat|mat
mata|mata
matilda|matilda
matiu|matiu
matthews|matthews
mauretania|mauretania
mavis|mavis
maxim|maxim
may|maj
me|me
media|media
medis|medis
melissa|melissa
mema|mema
meri|meri
mexico|mexico
mezaia|mezaia
mianmian|mianmian
michael|michael
mieke|mieke
milan|milan
mildred|mildred
milky|milkj
million|million
milton|milton
minaẹn|minaɛn
ministry|ministrj
minor|minor
minọ|minɔ
miotọ|miotɔ
mirjana|mirjana
mishnah|mishnah
misiaẹl|misiaɛl
mistelbach|mistelbach
miuhunmwu|miuhunʋu
mizuho|mizuho
miẹfan|miɛfan
miẹke|miɛke
miẹn|miɛn
miẹnfan|miɛnfan
miẹnrẹn|miɛnrɛn
miọn|miɔn
mobọ|mobɔ
modẹkai|modɛkai
moldova|moldova
molohan|molohan
monique|monique
montevideo|montevideo
mose|mose
mosemose|mosemose
moses|moses
mosis|mosis
moussanett|moussanett
mozis|mozis
mozisi|mozisi
mu|mu
muan|muan
muanẹmwẹ|muanɛʋɛ
muaẹmwẹ|muaɛʋɛ
mudia|mudia
mudiaẹse|mudiaɛse
muegbe|mueɡbe
muegberrioto|mueɡbeɽioto
muegberriotọ|mueɡbeɽiotɔ
mugbọ|muɡbɔ
mumu|mumu
muna|muna
munọ|munɔ
muobọ|muobɔ
muolọ|muolɔ
muotọ|muotɔ
musoẹ|musoɛ
musọe|musɔe
mutsuo|mutsuo
muẹmuẹ|muɛmuɛ
muẹn|muɛn
muẹnmuẹn|muɛnmuɛn
muẹnso|muɛnso
muẹtinyan|muɛtinjan
mwa|ʋa
mwaan|ʋaan
mwamwa|ʋaʋa
mwamwaẹn|ʋaʋaɛn
mwẹ|ʋɛ
my|mj
myanmar|mjanmar
mẹ|mɛ
mẹriba|mɛriba
mẹsini|mɛsini
mẹtusẹla|mɛtusɛla
mẹzaia|mɛzaia
mẹziaia|mɛziaia
mọ|mɔ
mọbọ|mɔbɔ
mọmọ|mɔmɔ
mọzis|mɔzis
mọẹn|mɔɛn
na|na
nabal|nabal
nación|nación
nadia|nadia
nadine|nadine
nagbọn|naɡbɔn
nai|nai
nain|nain
naira|naira
name|name
nana|nana
nanaẹn|nanaɛn
nancy|nancj
nao|nao
naryn|narjn
natan|natan
nataniẹl|nataniɛl
nathan|nathan
nation|nation
national|national
nazarẹt|nazarɛt
nazarẹti|nazarɛti
nazi|nazi
ne|ne
nebal|nebal
nebraska|nebraska
need|need
neh|neh
nehimaia|nehimaia
nekherhe|nexeɾe
nekhua|nexua
nekhui|nexui
nekhuẹrhẹ|nexuɛɾɛ
nekpa|nekpa
neman|neman
nene|nene
netherlands|netherlands
new|new
newry|newrj
news|news
nezlobnaya|nezlobnaja
nhrer|nhrer
ni|ni
nia|nia
nian|nian
niania|niania
nianian|nianian
nianiaẹn|nianiaɛn
nibun|nibun
nii|nii
nikaro|nikaro
nikhua|nixua
nikhuo|nixuo
nikhuọ|nixuɔ
nikodimọs|nikodimɔs
nikolai|nikolai
nikpia|nikpia
nikẹre|nikɛre
ninevi|ninevi
ninivẹ|ninivɛ
nisan|nisan
nizhniy|nizhnij
niẹn|niɛn
no|no
noa|noa
noam|noam
nodẹ|nodɛ
noemi|noemi
nogie|nogie
nogieha|nogieha
nogienẹ|nogienɛ
nogieva|nogieva
nokaro|nokaro
nokhua|noxua
nokhuo|noxuo
nokhuọ|noxuɔ
nokiekie|nokiekie
nokpia|nokpia
noma|noma
noncommissioned|noncommissioned
nora|nora
north|north
nov|nov
november|november
novgorod|novgorod
noyaenmwa|nojaenʋa
noyaẹnmwa|nojaɛnʋa
nu|nu
nueva|nueva
nukpogieha|nukpogieha
nukpogieva|nukpogieva
nun|nun
nuẹn|nuɛn
nw|nw
nyzhnya|njzhnja
nẹ|nɛ
nẹdẹ|nɛdɛ
nẹdẹso|nɛdɛso
nẹi|nɛi
nẹẹn|nɛɛn
nọ|nɔ
nọbun|nɔbun
nọdiọn|nɔdiɔn
nọfua|nɔfua
nọgbae|nɔɡbae
nọgbaisi|nɔɡbaisi
nọghayayerriọ|nɔɣajajeɽiɔ
nọhhuanrẹn|nɔhhuanrɛn
nọhuanrẹn|nɔhuanrɛn
nọkhin|nɔxin
nọkhua|nɔxua
nọkhuo|nɔxuo
nọkpa|nɔkpa
nọkpia|nɔkpia
nọkpọlọ|nɔkpɔlɔ
nọkẹre|nɔkɛre
nọm|nɔm
nọmbas|nɔmbas
nọnaghiyerriọ|nɔnaɣijeɽiɔ
nọra|nɔra
nọyaẹmwa|nɔjaɛʋa
nọyaẹnmwa|nɔjaɛnʋa
o|o
oath|oath
oba|oba
obaligie|obaligie
obalọ|obalɔ
oberhọmwa|obeɾɔʋa
obiyọmwa|obijɔʋa
obo|obo
obobo|obobo
obuẹ|obuɛ
obẹd|obɛd
obẹlẹ|obɛlɛ
obọ|obɔ
obọkhian|obɔxian
obọkpa|obɔkpa
oct|oct
october|october
odafẹn|odafɛn
odakha|odaxa
odaro|odaro
odede|odede
odekun|odekun
odibo|odibo
odibosa|odibosa
odin|odin
odiọn|odiɔn
odo|odo
ododo|ododo
odukhunmwu|oduxunʋu
oduma|oduma
odẹ|odɛ
odẹkodẹ|odɛkodɛ
odọ|odɔ
odọni|odɔni
of|of
officers|officers
offices|offices
ofigbọn|ofiɡbɔn
ofunmwegbe|ofunʋeɡbe
ofẹn|ofɛn
ogba|oɡba
ogberhu|oɡbeɾu
ogbewerriẹ|oɡbeweɽiɛ
ogboi|oɡboi
ogege|ogege
oghe|oɣe
oghian|oɣian
oghodan|oɣodan
oghodua|oɣodua
oghohọn|oɣohɔn
oghunmwu|oɣunʋu
oghẹ|oɣɛ
oghẹe|oɣɛe
oghẹn|oɣɛn
oghọghọ|oɣɔɣɔ
ogi|ogi
ogiasọn|ogiasɔn
ogie|ogie
ogiete|ogiete
ogieva|ogieva
ogiogiẹ|ogiogiɛ
ogiohẹn|ogiohɛn
ogiukpo|ogiukpo
ogiẹ|ogiɛ
ogua|ogua
ogue|ogue
oguomizan|oguomizan
oguozizi|oguozizi
oha|oha
ohan|ohan
ohanabe|ohanabe
ohanmwẹ|ohanʋɛ
ohawa|ohawa
ohian|ohian
ohioro|ohioro
ohiẹn|ohiɛn
ohoghe|ohoɣe
ohoghẹ|ohoɣɛ
ohoho|ohoho
ohu|ohu
ohuan|ohuan
ohẹn|ohɛn
ohọ|ohɔ
ohọhọ|ohɔhɔ
okaolotu|okaolotu
okaro|okaro
oke|oke
okeke|okeke
okha|oxa
okhian|oxian
okhioha|oxioha
okhirhikhirhi|oxiɾixiɾi
okhiẹ|oxiɛ
okhiọnkpa|oxiɔnkpa
okhuae|oxuae
okhuo|oxuo
okhuẹn|oxuɛn
okhuọ|oxuɔ
okhọn|oxɔn
okhọngborrie|oxɔnɡboɽie
okiekie|okiekie
okin|okin
oko|oko
okoro|okoro
okotọ|okotɔ
okozẹ|okozɛ
okpa|okpa
okpamẹ|okpamɛ
okpe|okpe
okperhan|okpeɾan
okpia|okpia
okpẹhoho|okpɛhoho
okpẹvbo|okpɛʋo
okpọmwa|okpɔʋa
okuku|okuku
okun|okun
okuo|okuo
okuta|okuta
okuọ|okuɔ
okọ|okɔ
olakpa|olakpa
ole|ole
olega|olega
oleghan|oleɣan
olga|olga
olighi|oliɣi
olika|olika
olinda|olinda
oliv|oliv
olive|olive
oliver|oliver
olivia|olivia
olodigba|olodiɡba
olodẹ|olodɛ
olokun|olokun
olotu|olotu
olympic|oljmpic
olẹga|olɛga
olẹtin|olɛtin
olọ|olɔ
omugui|omugui
omuhẹn|omuhɛn
omurhia|omuɾia
omuru|omuru
omuyan|omujan
omwa|oʋa
omwaikọmwa|oʋaikɔʋa
omọ|omɔ
on|on
ona|ona
oni|oni
online|online
onurho|onuɾo
ore|ore
oregbe|oreɡbe
oreghe|oreɣe
orere|orere
org|org
orheyerriọ|oɾejeɽiɔ
orhiema|oɾiema
orhikhan|oɾixan
orhion|oɾion
orhirhi|oɾiɾi
orhiẹnrhiẹn|oɾiɛnɾiɛn
orhiọn|oɾiɔn
orhiọnkpa|oɾiɔnkpa
orhu|oɾu
orhuan|oɾuan
orhuaẹn|oɾuaɛn
orhukhọ|oɾuxɔ
orhumwunyẹn|oɾuʋunjɛn
orhunmuyẹn|oɾunmujɛn
orhunmwu|oɾunʋu
orhunmwuyẹn|oɾunʋujɛn
orhọ|oɾɔ
orhọnmwẹ|oɾɔnʋɛ
ori|ori
orikhan|orixan
orinmwi|orinʋi
oro|oro
orre|oɽe
orriara|oɽiara
orriarria|oɽiaɽia
orriete|oɽiete
orrirri|oɽiɽi
orruan|oɽuan
orrẹ|oɽɛ
oru|oru
orueghe|orueɣe
orueghẹ|orueɣɛ
orukho|oruxo
orukhọ|oruxɔ
orukohọ|orukohɔ
orọnmwẹ|orɔnʋɛ
osa|osa
osanbua|osanbua
osanoba|osanoba
osanobua|osanobua
osanobuạ|osanobuạ
ose|ose
oseghe|oseɣe
osi|osi
osie|osie
osisi|osisi
osuan|osuan
osugi|osugi
osẹ|osɛ
osẹe|osɛe
ota|ota
otagbọn|otaɡbɔn
otako|otako
oteghe|oteɣe
oti|oti
otiti|otiti
otiẹn|otiɛn
otiọnrẹn|otiɔnrɛn
oto|oto
ototọ|ototɔ
otu|otu
otue|otue
otuẹ|otuɛ
otẹko|otɛko
otẹn|otɛn
otọ|otɔ
otọe|otɔe
otọre|otɔre
our|our
out|out
ova|ova
ovan|ovan
ovbe|oʋe
ovbehe|oʋehe
ovbi|oʋi
ovbialeke|oʋialeke
ovbimwẹ|oʋiʋɛ
ovbiogue|oʋiogue
ovbioguẹ|oʋioguɛ
ovbiotu|oʋiotu
ovbiran|oʋiran
ovbiyikuo|oʋijikuo
ovbiyokuo|oʋijokuo
ovbiẹre|oʋiɛre
ovbuẹ|oʋuɛ
overcoming|overcoming
overseer|overseer
ovẹn|ovɛn
owa|owa
owara|owara
owebe|owebe
owiẹ|owiɛ
owogho|owoɣo
owẹ|owɛ
owẹn|owɛn
oxford|oxford
oya|oja
oyanghan|ojanɣan
oyaya|ojaja
oyi|oji
oyunnuan|ojunnuan
oyọnyọn|ojɔnjɔn
ozan|ozan
oze|oze
ozere|ozere
oziguẹ|oziguɛ
oziya|ozija
p|p
packard|packard
pailet|pailet
pakistan|pakistan
palestine|palestine
pancreas|pancreas
paradais|paradais
paradise|paradise
paraguay|paraguaj
parents|parents
parkinson|parkinson
patience|patience
paul|paul
paula|paula
pavel|pavel
pe|pe
pennsylvania|pennsjlvania
pentecost|pentecost
people|people
perrine|peɽine
persuasion|persuasion
peshawar|peshawar
pesia|pesia
pet|pet
peter|peter
philip|philip
philippines|philippines
pine|pine
pioneer|pioneer
pirhi|piɾi
pirhipirhi|piɾipiɾi
pisidia|pisidia
pit|pit
pita|pita
piẹnpiẹnpiẹn|piɛnpiɛnpiɛn
placard|placard
planning|planning
poetzinger|poetzinger
pol|pol
polo|polo
portuguese|portuguese
post|post
potik|potik
pp|pp
pray|praj
prevent|prevent
print|print
printi|printi
priska|priska
problems|problems
professor|professor
promise|promise
propaganda|propaganda
properly|properlj
protection|protection
protestant|protestant
pryce|prjce
psalm|psalm
psm|psm
publications|publications
pursue|pursue
puteoli|puteoli
pẹgamọm|pɛgamɔm
pẹnina|pɛnina
pẹnsiọn|pɛnsiɔn
pẹnt|pɛnt
pẹntikọst|pɛntikɔst
pẹpẹ|pɛpɛ
pẹsia|pɛsia
pẹtrol|pɛtrol
pọl|pɔl
pọntiọs|pɔntiɔs
pọntus|pɔntus
pọtifa|pɔtifa
queen|queen
queenstown|queenstown
questions|questions
quetta|quetta
r|r
ra|ra
rabshakeh|rabshakeh
rachel|rachel
rae|rae
rainbow|rainbow
raising|raising
rakiẹl|rakiɛl
ramah|ramah
ran|ran
ranran|ranran
rantis|rantis
rape|rape
rapu|rapu
raya|raja
re|re
reading|reading
really|reallj
ree|ree
references|references
regained|regained
rehab|rehab
rehoboam|rehoboam
rekab|rekab
rekiẹl|rekiɛl
renee|renee
rentis|rentis
republic|republic
research|research
reward|reward
reylene|rejlene
rha|ɾa
rhaa|ɾaa
rhaan|ɾaan
rhan|ɾan
rhanmwẹ|ɾanʋɛ
rhe|ɾe
rherhe|ɾeɾe
rhia|ɾia
rhiae|ɾiae
rhiakhi|ɾiaxi
rhiara|ɾiara
rhie|ɾie
rhiegba|ɾieɡba
rhiegbe|ɾieɡbe
rhiema|ɾiema
rhiere|ɾiere
rhietẹ|ɾietɛ
rhihe|ɾihe
rhikhan|ɾixan
rhilo|ɾilo
rhinrin|ɾinrin
rhiotọ|ɾiotɔ
rhirhi|ɾiɾi
rhiẹn|ɾiɛn
rhiẹnmwẹ|ɾiɛnʋɛ
rhiẹnrhiẹn|ɾiɛnɾiɛn
rhiẹnrhiẹnmwẹ|ɾiɛnɾiɛnʋɛ
rhiẹre|ɾiɛre
rhiẹrhiẹn|ɾiɛɾiɛn
rhiọ|ɾiɔ
rhiọkpaegbe|ɾiɔkpaeɡbe
rhiọrre|ɾiɔɽe
rho|ɾo
rhooro|ɾooro
rhorho|ɾoɾo
rhovbiẹ|ɾoʋiɛ
rhrunmwuda|ɾrunʋuda
rhu|ɾu
rhua|ɾua
rhuan|ɾuan
rhuaro|ɾuaro
rhulẹ|ɾulɛ
rhumwuda|ɾuʋuda
rhunmuda|ɾunmuda
rhunmuwda|ɾunmuwda
rhunmwda|ɾunʋda
rhunmwuda|ɾunʋuda
rhunmwunda|ɾunʋunda
rhunnwuda|ɾunnwuda
rhunwmuda|ɾunwmuda
rhurhẹ|ɾuɾɛ
rhuẹ|ɾuɛ
rhuẹre|ɾuɛre
rhuọ|ɾuɔ
rhẹghẹrẹ|ɾɛɣɛrɛ
rhọ|ɾɔ
rhọkpa|ɾɔkpa
riana|riana
ribeiro|ribeiro
riberalta|riberalta
riga|riga
rinmwian|rinʋian
rinmwiaẹn|rinʋiaɛn
ro|ro
robert|robert
rodney|rodnej
roger|roger
roiro|roiro
rom|rom
roro|roro
rose|rose
rra|ɽa
rraa|ɽaa
rran|ɽan
rre|ɽe
rree|ɽee
rri|ɽi
rria|ɽia
rriabe|ɽiabe
rriara|ɽiara
rriase|ɽiase
rrie|ɽie
rriotọ|ɽiotɔ
rrioya|ɽioja
rriẹ|ɽiɛ
rriọkpaegbe|ɽiɔkpaeɡbe
rriọkpagbe|ɽiɔkpaɡbe
rriọmwẹ|ɽiɔʋɛ
rrua|ɽua
rrẹkọd|ɽɛkɔd
rrẹkọdi|ɽɛkɔdi
rrọ|ɽɔ
rrọọ|ɽɔɔ
rto|rto
ru|ru
rua|rua
ruan|ruan
rubẹn|rubɛn
rudy|rudj
rue|rue
rueghe|rueɣe
rukhọ|ruxɔ
runagban|runaɡban
rune|rune
rusell|rusell
rusk|rusk
russell|russell
russia|russia
rut|rut
ruth|ruth
rutherford|rutherford
rutland|rutland
ruẹ|ruɛ
ruẹe|ruɛe
ruẹn|ruɛn
ruọ|ruɔ
rwanda|rwanda
rẹ|rɛ
rẹfidim|rɛfidim
rẹghẹrẹ|rɛɣɛrɛ
rẹn|rɛn
rẹnkhuan|rɛnxuan
rẹnkhẹn|rɛnxɛn
rẹnrẹn|rɛnrɛn
rẹrẹ|rɛrɛ
rọkhọ|rɔxɔ
rọkhọe|rɔxɔe
rọkhọrọkhọ|rɔxɔrɔxɔ
rọkhọọ|rɔxɔɔ
rọn|rɔn
rọnmwẹ|rɔnʋɛ
s|s
sa|sa
sachio|sachio
sadiq|sadiq
sadusi|sadusi
safety|safetj
safira|safira
saidọn|saidɔn
sailas|sailas
saimọn|saimɔn
saina|saina
sainai|sainai
saiprọs|saiprɔs
sairọs|sairɔs
sakaan|sakaan
sakhalin|saxalin
sakiko|sakiko
sakua|sakua
sakura|sakura
salvador|salvador
sam|sam
sameria|sameria
samuel|samuel
samuẹl|samuɛl
san|san
sanhedrin|sanhedrin
sankaẹn|sankaɛn
santos|santos
saransk|saransk
sasa|sasa
sascha|sascha
satan|satan
satọde|satɔde
sawọn|sawɔn
sayọ|sajɔ
schama|schama
schladming|schladming
school|school
schroeder|schroeder
scotland|scotland
scriptures|scriptures
se|se
sea|sea
sebastian|sebastian
secret|secret
see|see
segbe|seɡbe
sekhae|sexae
sekpe|sekpe
senakẹrib|senakɛrib
sept|sept
september|september
septuagint|septuagint
sera|sera
serbia|serbia
serednye|serednje
sergio|sergio
serriọ|seɽiɔ
servant|servant
service|service
set|set
setan|setan
setin|setin
seventy|seventj
shall|shall
sheba|sheba
shimei|shimei
shobay|shobaj
should|should
si|si
siberia|siberia
sie|sie
siegbe|sieɡbe
siemaia|siemaia
sierra|sieɽa
sign|sign
sikan|sikan
sikh|six
siko|siko
sikẹ|sikɛ
sila|sila
silasila|silasila
silo|silo
silvana|silvana
simeon|simeon
simiọn|simiɔn
simon|simon
simone|simone
sin|sin
sinagọg|sinagɔg
sinagọgi|sinagɔgi
sinclair|sinclair
sing|sing
singh|sinɣ
single|single
sinmwi|sinʋi
sinmwin|sinʋin
sirach|sirach
sirra|siɽa
sisiak|sisiak
situa|situa
siunẹm|siunɛm
sivulsky|sivulskj
siẹbna|siɛbna
siẹkẹm|siɛkɛm
siẹn|siɛn
siẹnro|siɛnro
ske|ske
skirt|skirt
skul|skul
sneddon|sneddon
snow|snow
so|so
sobọ|sobɔ
society|societj
sodọm|sodɔm
sokpan|sokpan
sokuluk|sokuluk
solomọn|solomɔn
someone|someone
somwa|soʋa
soso|soso
sotọ|sotɔ
south|south
soviet|soviet
soviẹt|soviɛt
soyaya|sojaja
soyẹnmwẹ|sojɛnʋɛ
spain|spain
spanish|spanish
spartak|spartak
specific|specific
spiritual|spiritual
split|split
sri|sri
stadium|stadium
state|state
states|states
steffen|steffen
stephanie|stephanie
stephen|stephen
stewart|stewart
stivin|stivin
stories|stories
street|street
strok|strok
studio|studio
study|studj
stéphanie|stéphanie
su|su
sua|sua
suan|suan
sudu|sudu
suffering|suffering
sugiẹ|sugiɛ
suigiẹ|suigiɛ
suiter|suiter
sukkur|sukkur
sultanalieva|sultanalieva
sumatra|sumatra
sumẹ|sumɛ
sunu|sunu
super|super
supply|supplj
supreme|supreme
susi|susi
susu|susu
susẹ|susɛ
suẹ|suɛ
suẹe|suɛe
suẹn|suɛn
suẹnrẹn|suɛnrɛn
svetlana|svetlana
swahili|swahili
sweden|sweden
swift|swift
switzerland|switzerland
sydlik|sjdlik
sylviana|sjlviana
sylvie|sjlvie
syndrome|sjndrome
syntyche|sjntjche
syriac|sjriac
sẹ|sɛ
sẹe|sɛe
sẹkhae|sɛxae
sẹlẹkẹ|sɛlɛkɛ
sẹnakẹrib|sɛnakɛrib
sẹnrẹn|sɛnrɛn
sẹrae|sɛrae
sẹre|sɛre
sẹrriọ|sɛɽiɔ
sẹt|sɛt
sẹtin|sɛtin
sẹẹ|sɛɛ
sọ|sɔ
sọdom|sɔdom
sọe|sɔe
sọfurre|sɔfuɽe
sọkpan|sɔkpan
sọl|sɔl
sọn|sɔn
sọnde|sɔnde
sọni|sɔni
sọnnọ|sɔnnɔ
sọnnọẹn|sɔnnɔɛn
sọnọ|sɔnɔ
sọrae|sɔrae
sọregbe|sɔreɡbe
sọs|sɔs
sọsi|sɔsi
sọtẹ|sɔtɛ
sọyẹmwẹ|sɔjɛʋɛ
sọyẹnmwẹ|sɔjɛnʋɛ
t|t
ta|ta
taa|taa
taara|taara
tabita|tabita
tacloban|tacloban
tae|tae
tagalog|tagalog
tagha|taɣa
taitọs|taitɔs
talinn|talinn
tallinn|tallinn
talmud|talmud
talọ|talɔ
talọẹ|talɔɛ
tama|tama
tamuolọyan|tamuolɔjan
tan|tan
tandroy|tandroj
tara|tara
tarlac|tarlac
taylor|tajlor
taẹn|taɛn
te|te
teach|teach
teachings|teachings
tebe|tebe
teenagers|teenagers
tengbemu|tenɡbemu
tennessee|tennessee
tertullian|tertullian
teskey|teskej
testament|testament
tetete|tetete
texas|texas
thailand|thailand
that|that
the|the
thecla|thecla
theocracy|theocracj
theocratic|theocratic
theological|theological
thierry|thieɽj
this|this
thomas|thomas
thompson|thompson
ti|ti
tian|tian
tiatira|tiatira
tie|tie
tiere|tiere
tiffany|tiffanj
tila|tila
tilae|tilae
tim|tim
time|time
times|times
timothy|timothj
timoti|timoti
timọti|timɔti
tin|tin
tipitapa|tipitapa
titanic|titanic
titi|titi
tititi|tititi
tiẹ|tiɛ
tiẹre|tiɛre
to|to
tobaija|tobaija
tobaijah|tobaijah
toby|tobj
tobọ|tobɔ
tobọre|tobɔre
tohan|tohan
tokmok|tokmok
too|too
tools|tools
toronto|toronto
torpedo|torpedo
tota|tota
tours|tours
tower|tower
tract|tract
tractor|tractor
traffic|traffic
transcarpathia|transcarpathia
translation|translation
trazel|trazel
trials|trials
trifaena|trifaena
trifosa|trifosa
troas|troas
truth|truth
tsunami|tsunami
tsunamis|tsunamis
tu|tu
tua|tua
tue|tue
tugie|tugie
tuke|tuke
tulun|tulun
tuo|tuo
tuorre|tuoɽe
turkey|turkej
tuẹ|tuɛ
tuẹin|tuɛin
tuọ|tuɔ
tv|tv
twentieth|twentieth
tyndale|tjndale
typewriter|tjpewriter
typhoon|tjphoon
tẹ|tɛ
tẹkpu|tɛkpu
tẹlifoni|tɛlifoni
tẹnrẹn|tɛnrɛn
tẹs|tɛs
tẹsalonaika|tɛsalonaika
tẹssalonaika|tɛssalonaika
tẹstimoni|tɛstimoni
tẹtẹtẹ|tɛtɛtɛ
tọ|tɔ
tọlọ|tɔlɔ
tọm|tɔm
tọn|tɔn
tọnnọ|tɔnnɔ
tọnnọẹn|tɔnnɔɛn
u|u
uan|uan
ubiẹmwẹ|ubiɛʋɛ
ubọmwẹ|ubɔʋɛ
udazi|udazi
ude|ude
udemwurri|udeʋuɽi
udemwẹ|udeʋɛ
udinmwimwẹ|udinʋiʋɛ
udinmwẹ|udinʋɛ
udu|udu
udẹmwẹ|udɛʋɛ
udẹn|udɛn
ufifimwẹ|ufifiʋɛ
ufomwẹ|ufoʋɛ
ufumwẹ|ufuʋɛ
ugamwe|ugaʋe
ugamwẹ|ugaʋɛ
ugan|ugan
ugbaro|uɡbaro
ugbe|uɡbe
ugbemwẹ|uɡbeʋɛ
ugbo|uɡbo
ugbogiorinmwi|uɡbogiorinʋi
ugboloko|uɡboloko
ugborhirhi|uɡboɾiɾi
ugborrirri|uɡboɽiɽi
ugbẹkun|uɡbɛkun
ugbẹn|uɡbɛn
ugbẹnso|uɡbɛnso
ugbẹnsọ|uɡbɛnsɔ
ugbẹnvbe|uɡbɛnʋe
ugha|uɣa
ughaghe|uɣaɣe
ughanmwa|uɣanʋa
ughaẹdẹ|uɣaɛdɛ
ughe|uɣe
ughegbe|uɣeɡbe
ughugha|uɣuɣa
ughughan|uɣuɣan
ugiasiẹn|ugiasiɛn
ugie|ugie
ugiọnmwẹ|ugiɔnʋɛ
ugue|ugue
uguọmwẹ|uguɔʋɛ
uhae|uhae
uhanhan|uhanhan
uhe|uhe
uhi|uhi
uhiomwẹ|uhioʋɛ
uhiẹn|uhiɛn
uhiọnrọnmwẹ|uhiɔnrɔnʋɛ
uhukpa|uhukpa
uhunmmwu|uhunmʋu
uhunmwu|uhunʋu
uhunmwuta|uhunʋuta
ui|ui
uighur|uiɣur
uigiasiẹn|uigiasiɛn
ujoko|ujoko
ukankan|ukankan
uke|uke
ukhiọnfọ|uxiɔnfɔ
ukhiọnmwẹ|uxiɔnʋɛ
ukhu|uxu
ukhuegbe|uxueɡbe
ukhuerhe|uxueɾe
ukhukhu|uxuxu
ukhunmwu|uxunʋu
ukhọmwẹ|uxɔʋɛ
uki|uki
uko|uko
ukoni|ukoni
ukpa|ukpa
ukpamoyọmọ|ukpamojɔmɔ
ukpamuyọmọ|ukpamujɔmɔ
ukpi|ukpi
ukpo|ukpo
ukpogie|ukpogie
ukpogieha|ukpogieha
ukpogiehan|ukpogiehan
ukpogienẹ|ukpogienɛ
ukpogieva|ukpogieva
ukpogihirọn|ukpogihirɔn
ukpogisẹn|ukpogisɛn
ukpokpo|ukpokpo
ukpon|ukpon
ukpowẹ|ukpowɛ
ukpu|ukpu
ukpukpo|ukpukpo
ukpunu|ukpunu
ukpẹ|ukpɛ
ukpọ|ukpɔ
ukpọba|ukpɔba
ukpọmọ|ukpɔmɔ
ukpọmọkpa|ukpɔmɔkpa
ukpọn|ukpɔn
ukraine|ukraine
uku|uku
ukọ|ukɔ
ukọnmwẹ|ukɔnʋɛ
ulema|ulema
ulf|ulf
ulẹ|ulɛ
ulẹmwẹ|ulɛʋɛ
uma|uma
umamwẹ|umaʋɛ
umanmwẹ|umanʋɛ
umaro|umaro
umian|umian
umiẹn|umiɛn
ummi|ummi
umozo|umozo
umwẹkhẹn|uʋɛxɛn
umẹkpo|umɛkpo
umẹwaẹn|umɛwaɛn
umọbọ|umɔbɔ
umọbọru|umɔbɔru
umọdia|umɔdia
uncovered|uncovered
union|union
united|united
uniẹn|uniɛn
uniọn|uniɔn
unu|unu
upper|upper
ur|ur
urdu|urdu
urho|uɾo
urhomwẹ|uɾoʋɛ
urhu|uɾu
urhuevbọ|uɾueʋɔ
urhuẹvbo|uɾuɛʋo
urhuẹvbọ|uɾuɛʋɔ
urhọmwẹ|uɾɔʋɛ
uromwẹ|uroʋɛ
urremwẹ|uɽeʋɛ
urri|uɽi
urria|uɽia
urriẹdẹ|uɽiɛdɛ
uruguay|uruguaj
uruhuẹvbo|uruhuɛʋo
urọnghọn|urɔnɣɔn
us|us
usakanmwẹ|usakanʋɛ
use|use
usi|usi
using|using
ussr|ussr
usugi|usugi
usun|usun
usẹ|usɛ
usọmwẹ|usɔʋɛ
usọnmwẹ|usɔnʋɛ
utanmwẹ|utanʋɛ
ute|ute
utiemwẹ|utieʋɛ
utikọs|utikɔs
utun|utun
uvbi|uʋi
uvbẹmwẹ|uʋɛʋɛ
uviẹn|uviɛn
uvun|uvun
uwa|uwa
uwanmwẹ|uwanʋɛ
uwaya|uwaja
uwerhẹn|uweɾɛn
uwinhinmwẹ|uwinhinʋɛ
uwu|uwu
uwẹ|uwɛ
uwẹnrhiẹn|uwɛnɾiɛn
uwọnmwẹ|uwɔnʋɛ
uye|uje
uyi|uji
uyinmwẹ|ujinʋɛ
uyomwẹ|ujoʋɛ
uyunmwu|ujunʋu
uzaia|uzaia
uzbek|uzbek
uzẹbu|uzɛbu
uzọla|uzɔla
va|va
van|van
vance|vance
vannọ|vannɔ
varter|varter
vasile|vasile
vba|ʋa
vbe|ʋe
vbekpa|ʋekpa
vbekpae|ʋekpae
vbene|ʋene
vbenia|ʋenia
vbenian|ʋenian
vberrio|ʋeɽio
vberriọ|ʋeɽiɔ
vberrriọ|ʋeɽriɔ
vbia|ʋia
vbirhi|ʋiɾi
vbiẹ|ʋiɛ
vbiẹre|ʋiɛre
vbo|ʋo
vbobọvbobọ|ʋobɔʋobɔ
vbozẹe|ʋozɛe
vbu|ʋu
vbua|ʋua
vburriẹ|ʋuɽiɛ
vbuwe|ʋuwe
vbuwẹ|ʋuwɛ
vbuọ|ʋuɔ
vbẹ|ʋɛ
vbẹre|ʋɛre
vbẹrre|ʋɛɽe
vbọ|ʋɔ
vbọghiyekede|ʋɔɣijekede
vbọghizẹkpẹ|ʋɔɣizɛkpɛ
vbọlọ|ʋɔlɔ
vbọre|ʋɔre
vbọrhirhighayehe|ʋɔɾiɾiɣajehe
vbọrhirhighayehẹ|ʋɔɾiɾiɣajehɛ
vbọsiẹ|ʋɔsiɛ
vbọzẹe|ʋɔzɛe
ve|ve
vee|vee
vekpae|vekpae
venezuela|venezuela
veracruz|veracruz
version|version
vian|vian
vicky|vickj
victor|victor
victoria|victoria
video|video
vidio|vidio
vietnam|vietnam
vietnamese|vietnamese
vin|vin
vinnọ|vinnɔ
vinter|vinter
vinọ|vinɔ
visa|visa
vitaly|vitalj
viẹ|viɛ
viẹn|viɛn
viọ|viɔ
vodyane|vodjane
volume|volume
volumes|volumes
vu|vu
vulgate|vulgate
vulo|vulo
vuẹ|vuɛ
vuọn|vuɔn
vẹ|vɛ
vẹn|vɛn
vẹwae|vɛwae
vẹẹ|vɛɛ
wa|wa
waa|waa
waan|waan
wabọ|wabɔ
wabọre|wabɔre
wabọrerua|wabɔrerua
waengbe|waenɡbe
wagha|waɣa
wainwain|wainwain
wallen|wallen
walter|walter
wan|wan
wanniẹn|wanniɛn
wannọ|wannɔ
wanwan|wanwan
warwick|warwick
watch|watch
watchtower|watchtower
way|waj
we|we
weaver|weaver
websait|websait
wee|wee
wegbe|weɡbe
weghe|weɣe
werrie|weɽie
werriegbe|weɽieɡbe
werriẹ|weɽiɛ
west|west
wewe|wewe
weẹ|weɛ
what|what
when|when
whiteboard|whiteboard
why|whj
wia|wia
wii|wii
wika|wika
willett|willett
william|william
willie|willie
winhin|winhin
winna|winna
winnaẹn|winnaɛn
wio|wio
wisdom|wisdom
with|with
without|without
witnesses|witnesses
wiẹn|wiɛn
wo|wo
wol|wol
woo|woo
word|word
work|work
world|world
worldwide|worldwide
worua|worua
wu|wu
wuegbe|wueɡbe
wulo|wulo
www|www
wycliffe|wjcliffe
wẹ|wɛ
wẹbsait|wɛbsait
wẹbsaiti|wɛbsaiti
wẹe|wɛe
wẹnrẹn|wɛnrɛn
wẹro|wɛro
wẹrriẹ|wɛɽiɛ
wẹwẹ|wɛwɛ
wẹẹ|wɛɛ
wọlọe|wɔlɔe
wọn|wɔn
wọrhọ|wɔɾɔ
wọọ|wɔɔ
xhosa|xhosa
ya|ja
yaa|jaa
yaba|jaba
yabọ|jabɔ
yabọe|jabɔe
yae|jae
yaeyi|jaeji
yagha|jaɣa
yagon|jagon
yama|jama
yan|jan
yangbe|janɡbe
yangbuẹ|janɡbuɛ
yanghan|janɣan
yankee|jankee
yanrẹn|janrɛn
yantzen|jantzen
yanyan|janjan
yaro|jaro
yaroslav|jaroslav
yayi|jaji
yaẹn|jaɛn
yaẹngbe|jaɛnɡbe
ye|je
yearbook|jearbook
years|jears
yegbe|jeɡbe
yerre|jeɽe
yerriọ|jeɽiɔ
yerẹro|jerɛro
yevbe|jeʋe
yevbesọni|jeʋesɔni
yi|ji
yin|jin
yinrin|jinrin
ymca|jmca
yo|jo
yobọ|jobɔ
yogọt|jogɔt
yola|jola
york|jork
yorkshire|jorkshire
yotọ|jotɔ
you|jou
young|joung
your|jour
yourselves|jourselves
yuen|juen
yufretis|jufretis
yunmwu|junʋu
yunu|junu
yuo|juo
yuẹ|juɛ
yẹ|jɛ
yẹnyẹn|jɛnjɛn
yẹrike|jɛrike
yẹrẹro|jɛrɛro
yẹẹ|jɛɛ
yọ|jɔ
yọghọ|jɔɣɔ
yọmwẹ|jɔʋɛ
yọn|jɔn
yọre|jɔre
z|z
zaan|zaan
zagha|zaɣa
zaghae|zaɣae
zaikiọs|zaikiɔs
zaikiọsi|zaikiɔsi
zaiọn|zaiɔn
zakiọsi|zakiɔsi
zambales|zambales
zan|zan
zanzan|zanzan
zaromiẹn|zaromiɛn
zaẹn|zaɛn
ze|ze
zealand|zealand
zedu|zedu
zeki|zeki
zevbe|zeʋe
zeynep|zejnep
zeze|zeze
ziengbe|zienɡbe
ziga|ziga
zihe|zihe
zihegbe|ziheɡbe
zin|zin
zinegbe|zineɡbe
zion|zion
ziro|ziro
ziẹn|ziɛn
zobọ|zobɔ
zogọ|zogɔ
zolotniki|zolotniki
zowẹ|zowɛ
zozo|zozo
zuan|zuan
zuze|zuze
zẹ|zɛ
zẹdekaia|zɛdekaia
zẹdekia|zɛdekia
zẹdia|zɛdia
zẹdẹ|zɛdɛ
zẹdẹkaia|zɛdɛkaia
zẹe|zɛe
zẹf|zɛf
zẹfanaia|zɛfanaia
zẹgiẹ|zɛgiɛ
zẹk|zɛk
zẹkaraia|zɛkaraia
zẹko|zɛko
zẹrafat|zɛrafat
zẹrubabẹl|zɛrubabɛl
zẹvbe|zɛʋe
zẹyọ|zɛjɔ
zẹẹ|zɛɛ
zẹẹẹ|zɛɛɛ
zọ|zɔ
zọe|zɔe
zọese|zɔese
zọghae|zɔɣae
zọkan|zɔkan
zọlọ|zɔlɔ
zọmọ|zɔmɔ
zọọ|zɔɔ
étaples|étaples
ẹ|ɛ
ẹbe|ɛbe
ẹbo|ɛbo
ẹbu|ɛbu
ẹbubẹ|ɛbubɛ
ẹbẹdmẹlẹk|ɛbɛdmɛlɛk
ẹbọ|ɛbɔ
ẹdagbọn|ɛdaɡbɔn
ẹde|ɛde
ẹdiọn|ɛdiɔn
ẹdogbo|ɛdoɡbo
ẹdẹ|ɛdɛ
ẹdẹdẹmwẹdẹ|ɛdɛdɛʋɛdɛ
ẹdẹgbegbe|ɛdɛɡbeɡbe
ẹdẹnẹre|ɛdɛnɛre
ẹdẹnẹrẹ|ɛdɛnɛrɛ
ẹdẹrriọ|ɛdɛɽiɔ
ẹdọ|ɛdɔ
ẹdọkpai|ɛdɔkpai
ẹfe|ɛfe
ẹfis|ɛfis
ẹfisọs|ɛfisɔs
ẹfẹ|ɛfɛ
ẹgbe|ɛɡbe
ẹgbo|ɛɡbo
ẹgbuẹ|ɛɡbuɛ
ẹgbẹdin|ɛɡbɛdin
ẹgbẹe|ɛɡbɛe
ẹghe|ɛɣe
ẹghẹ|ɛɣɛ
ẹghẹe|ɛɣɛe
ẹghẹikẹghẹ|ɛɣɛikɛɣɛ
ẹgiẹgiẹ|ɛgiɛgiɛ
ẹgiọn|ɛgiɔn
ẹgogo|ɛgogo
ẹguae|ɛguae
ẹgun|ɛgun
ẹguẹ|ɛguɛ
ẹgẹn|ɛgɛn
ẹho|ɛho
ẹhoho|ɛhoho
ẹi|ɛi
ẹkete|ɛkete
ẹkhabe|ɛxabe
ẹkhae|ɛxae
ẹkhokho|ɛxoxo
ẹkhu|ɛxu
ẹkhuia|ɛxuia
ẹkhọe|ɛxɔe
ẹki|ɛki
ẹko|ɛko
ẹkoata|ɛkoata
ẹkokoudu|ɛkokoudu
ẹkorhiẹnrhiẹnmwẹ|ɛkoɾiɛnɾiɛnʋɛ
ẹkpo|ɛkpo
ẹkpotọ|ɛkpotɔ
ẹkpurhu|ɛkpuɾu
ẹkpẹn|ɛkpɛn
ẹkpẹti|ɛkpɛti
ẹkpẹtin|ɛkpɛtin
ẹks|ɛks
ẹksodọs|ɛksodɔs
ẹkun|ɛkun
ẹkẹ|ɛkɛ
ẹlaihu|ɛlaihu
ẹlaija|ɛlaija
ẹlaisia|ɛlaisia
ẹlasia|ɛlasia
ẹlizabẹt|ɛlizabɛt
ẹlẹtrik|ɛlɛtrik
ẹmila|ɛmila
ẹmu|ɛmu
ẹmwa|ɛʋa
ẹmwata|ɛʋata
ẹmwi|ɛʋi
ẹmwẹ|ɛʋɛ
ẹn|ɛn
ẹnina|ɛnina
ẹnrẹn|ɛnrɛn
ẹnvẹlop|ɛnvɛlop
ẹo|ɛo
ẹpaonetọs|ɛpaonetɔs
ẹre|ɛre
ẹrherhe|ɛɾeɾe
ẹrhia|ɛɾia
ẹrhiọn|ɛɾiɔn
ẹrhu|ɛɾu
ẹrhunmwu|ɛɾunʋu
ẹrhunrhun|ɛɾunɾun
ẹrhẹe|ɛɾɛe
ẹrhẹn|ɛɾɛn
ẹrinmmwi|ɛrinmʋi
ẹrinmwi|ɛrinʋi
ẹro|ɛro
ẹrria|ɛɽia
ẹrriọ|ɛɽiɔ
ẹrẹ|ɛrɛ
ẹrẹna|ɛrɛna
ẹrọnmwọ|ɛrɔnʋɔ
ẹse|ɛse
ẹseọhẹ|ɛseɔhɛ
ẹsin|ɛsin
ẹsiso|ɛsiso
ẹsoghodan|ɛsoɣodan
ẹsta|ɛsta
ẹsẹ|ɛsɛ
ẹsẹse|ɛsɛse
ẹsẹsẹmwẹse|ɛsɛsɛʋɛse
ẹsọhẹ|ɛsɔhɛ
ẹsọn|ɛsɔn
ẹsọsi|ɛsɔsi
ẹti|ɛti
ẹtien|ɛtien
ẹtin|ɛtin
ẹtiopia|ɛtiopia
ẹtu|ɛtu
ẹtẹ|ɛtɛ
ẹtẹbitẹ|ɛtɛbitɛ
ẹtẹn|ɛtɛn
ẹvbi|ɛʋi
ẹvbo|ɛʋo
ẹvbohoho|ɛʋohoho
ẹwae|ɛwae
ẹwaen|ɛwaen
ẹwanniẹn|ɛwanniɛn
ẹwaẹn|ɛwaɛn
ẹwerẹ|ɛwerɛ
ẹwobi|ɛwobi
ẹwu|ɛwu
ẹwạen|ɛwạen
ẹwẹ|ɛwɛ
ẹwẹe|ɛwɛe
ẹwẹn|ɛwɛn
ẹyaẹn|ɛjaɛn
ẹyotọ|ɛjotɔ
ẹyẹn|ɛjɛn
ẹzi|ɛzi
ẹzik|ɛzik
ẹzikiẹl|ɛzikiɛl
ẹzra|ɛzra
ẹzẹ|ɛzɛ
ẹzọ|ɛzɔ
ẹẹn|ɛɛn
ọ|ɔ
ọba|ɔba
ọbafi|ɔbafi
ọbaligie|ɔbaligie
ọbevbaru|ɔbeʋaru
ọbo|ɔbo
ọbokhian|ɔboxian
ọbude|ɔbude
ọbuohiẹn|ɔbuohiɛn
ọbọ|ɔbɔ
ọbọbọtizọ|ɔbɔbɔtizɔ
ọdafẹn|ɔdafɛn
ọdafọn|ɔdafɔn
ọdakha|ɔdaxa
ọde|ɔde
ọdia|ɔdia
ọdion|ɔdion
ọdiọn|ɔdiɔn
ọdoẹki|ɔdoɛki
ọduẹki|ɔduɛki
ọdẹ|ɔdɛ
ọdẹn|ɔdɛn
ọdọ|ɔdɔ
ọfiontọ|ɔfiontɔ
ọfisi|ɔfisi
ọfuan|ɔfuan
ọfumwegbe|ɔfuʋeɡbe
ọfunmwegbe|ɔfunʋeɡbe
ọfunmwẹgbe|ɔfunʋɛɡbe
ọfọ|ɔfɔ
ọgbagbọn|ɔɡbaɡbɔn
ọgbalegbe|ɔɡbaleɡbe
ọgban|ɔɡban
ọgbaroghe|ɔɡbaroɣe
ọgbehẹn|ɔɡbehɛn
ọgbenbe|ɔɡbenbe
ọgbugbo|ɔɡbuɡbo
ọgbẹlẹzẹ|ɔɡbɛlɛzɛ
ọgbẹn|ɔɡbɛn
ọgbọ|ɔɡbɔ
ọgbọmwa|ɔɡbɔʋa
ọgbọn|ɔɡbɔn
ọghae|ɔɣae
ọghe|ɔɣe
ọghian|ɔɣian
ọghomwa|ɔɣoʋa
ọghomwẹ|ɔɣoʋɛ
ọghuẹ|ɔɣuɛ
ọghẹ|ɔɣɛ
ọghẹe|ɔɣɛe
ọghọ|ɔɣɔ
ọghọe|ɔɣɔe
ọghọmwa|ɔɣɔʋa
ọgiọrọ|ɔgiɔrɔ
ọgua|ɔgua
ọguọmwadia|ɔguɔʋadia
ọguọmwaziro|ɔguɔʋaziro
ọhan|ɔhan
ọhanabe|ɔhanabe
ọhẹ|ɔhɛ
ọka|ɔka
ọkade|ɔkade
ọkan|ɔkan
ọkaokuo|ɔkaokuo
ọkaolotu|ɔkaolotu
ọkemwiokọ|ɔkeʋiokɔ
ọkhaẹn|ɔxaɛn
ọkhioha|ɔxioha
ọkhẹ|ɔxɛ
ọkhọ|ɔxɔ
ọkhọe|ɔxɔe
ọkhọnmwoti|ɔxɔnʋoti
ọkhọnmwẹ|ɔxɔnʋɛ
ọkiẹkiẹ|ɔkiɛkiɛ
ọkpa|ɔkpa
ọkpadin|ɔkpadin
ọkpan|ɔkpan
ọkpanike|ɔkpanike
ọkpankpan|ɔkpankpan
ọkpẹn|ɔkpɛn
ọkpẹre|ɔkpɛre
ọkpọ|ɔkpɔ
ọkpọkpa|ɔkpɔkpa
ọkpọkua|ɔkpɔkua
ọkẹn|ɔkɛn
ọkẹnrẹn|ɔkɛnrɛn
ọlarre|ɔlaɽe
ọlọghọmwa|ɔlɔɣɔʋa
ọlọkọmwọrhu|ɔlɔkɔʋɔɾu
ọmakin|ɔmakin
ọmamwaemwi|ɔmaʋaeʋi
ọmaẹn|ɔmaɛn
ọmerhan|ɔmeɾan
ọmo|ɔmo
ọmobọ|ɔmobɔ
ọmokhuo|ɔmoxuo
ọmokpia|ɔmokpia
ọmotọ|ɔmotɔ
ọmunu|ɔmunu
ọmwa|ɔʋa
ọmwaikọmwa|ɔʋaikɔʋa
ọmwakọmwa|ɔʋakɔʋa
ọmwata|ɔʋata
ọmẹhẹ|ɔmɛhɛ
ọmọ|ɔmɔ
ọmọdiọn|ɔmɔdiɔn
ọmọkhuo|ɔmɔxuo
ọmọmọ|ɔmɔmɔ
ọna|ɔna
ọni|ɔni
ọnii|ɔnii
ọnrẹn|ɔnrɛn
ọpia|ɔpia
ọre|ɔre
ọrheyerriọ|ɔɾejeɽiɔ
ọrhiae|ɔɾiae
ọrhiọn|ɔɾiɔn
ọrho|ɔɾo
ọrhuanegbe|ɔɾuaneɡbe
ọrhẹnrhẹn|ɔɾɛnɾɛn
ọrriẹ|ɔɽiɛ
ọrue|ɔrue
ọrẹ|ɔrɛ
ọrọnmwẹ|ɔrɔnʋɛ
ọrọre|ɔrɔre
ọsa|ɔsa
ọsanobua|ɔsanobua
ọse|ɔse
ọsian|ɔsian
ọsie|ɔsie
ọsiemwiẹnro|ɔsieʋiɛnro
ọsihuan|ɔsihuan
ọsiọre|ɔsiɔre
ọsosẹ|ɔsosɛ
ọsumẹ|ɔsumɛ
ọsuohuan|ɔsuohuan
ọta|ɔta
ọtakhọ|ɔtaxɔ
ọten|ɔten
ọtien|ɔtien
ọtiẹn|ɔtiɛn
ọtiọn|ɔtiɔn
ọtiọnrẹn|ɔtiɔnrɛn
ọto|ɔto
ọtokha|ɔtoxa
ọtuẹn|ɔtuɛn
ọtẹn|ɔtɛn
ọtẹnmwẹ|ɔtɛnʋɛ
ọtọn|ɔtɔn
ọvbehe|ɔʋehe
ọvbi|ɔʋi
ọvbiotu|ɔʋiotu
ọvbokhan|ɔʋoxan
ọviẹn|ɔviɛn
ọwa|ɔwa
ọwara|ɔwara
ọwarokpa|ɔwarokpa
ọwarọkpa|ɔwarɔkpa
ọwarọkpani|ɔwarɔkpani
ọwiẹghẹ|ɔwiɛɣɛ
ọwiẹyi|ɔwiɛji
ọwẹwẹ|ɔwɛwɛ
ọwọrhọwọrhọ|ɔwɔɾɔwɔɾɔ
ọya|ɔja
ọyan|ɔjan
ọyasin|ɔjasin
ọyobọ|ɔjobɔ
ọyunnuan|ɔjunnuan
ọyẹnmwe|ɔjɛnʋe
ọyẹnmwẹ|ɔjɛnʋɛ
ọyẹvbu|ɔjɛʋu
ọza|ɔza
ọzedu|ɔzedu
ọzuọ|ɔzuɔ
